LIS,STATE_NAME,STATE_FIPS,COUNTY_NAME,COUNTY_FIPS,BENE_YES,BENE_NO,TOTAL_BENE,BENE_YES_PCT
No,Alabama,1,"Autauga County",1001,833,183,1016,0.8198818898
No,Alabama,1,"Baldwin County",1003,4500,942,5442,0.8269018743
No,Alabama,1,"Barbour County",1005,478,134,612,0.7810457516
No,Alabama,1,"Bibb County",1007,319,104,423,0.7541371158
No,Alabama,1,"Blount County",1009,1268,257,1525,0.8314754098
No,Alabama,1,"Bullock County",1011,158,40,198,0.797979798
No,Alabama,1,"Butler County",1013,478,136,614,0.7785016287
No,Alabama,1,"Calhoun County",1015,2225,514,2739,0.8123402702
No,Alabama,1,"Chambers County",1017,778,188,966,0.8053830228
No,Alabama,1,"Cherokee County",1019,767,185,952,0.8056722689
No,Alabama,1,"Chilton County",1021,755,207,962,0.7848232848
No,Alabama,1,"Choctaw County",1023,475,97,572,0.8304195804
No,Alabama,1,"Clarke County",1025,634,166,800,0.7925
No,Alabama,1,"Clay County",1027,379,85,464,0.8168103448
No,Alabama,1,"Cleburne County",1029,323,97,420,0.769047619
No,Alabama,1,"Coffee County",1031,756,199,955,0.7916230366
No,Alabama,1,"Colbert County",1033,1542,426,1968,0.7835365854
No,Alabama,1,"Conecuh County",1035,325,100,425,0.7647058824
No,Alabama,1,"Coosa County",1037,283,98,381,0.7427821522
No,Alabama,1,"Covington County",1039,971,268,1239,0.7836965295
No,Alabama,1,"Crenshaw County",1041,288,72,360,0.8
No,Alabama,1,"Cullman County",1043,2273,442,2715,0.8372007366
No,Alabama,1,"Dale County",1045,682,155,837,0.8148148148
No,Alabama,1,"Dallas County",1047,709,233,942,0.7526539278
No,Alabama,1,"DeKalb County",1049,1544,357,1901,0.8122041031
No,Alabama,1,"Elmore County",1051,1326,324,1650,0.8036363636
No,Alabama,1,"Escambia County",1053,894,254,1148,0.7787456446
No,Alabama,1,"Etowah County",1055,2776,657,3433,0.8086221963
No,Alabama,1,"Fayette County",1057,467,120,587,0.7955706985
No,Alabama,1,"Franklin County",1059,811,181,992,0.8175403226
No,Alabama,1,"Geneva County",1061,547,159,706,0.7747875354
No,Alabama,1,"Greene County",1063,154,38,192,0.8020833333
No,Alabama,1,"Hale County",1065,299,77,376,0.795212766
No,Alabama,1,"Henry County",1067,461,107,568,0.8116197183
No,Alabama,1,"Houston County",1069,2250,538,2788,0.8070301291
No,Alabama,1,"Jackson County",1071,1578,365,1943,0.8121461657
No,Alabama,1,"Jefferson County",1073,10375,2494,12869,0.806200948
No,Alabama,1,"Lamar County",1075,441,110,551,0.8003629764
No,Alabama,1,"Lauderdale County",1077,2566,574,3140,0.8171974522
No,Alabama,1,"Lawrence County",1079,999,232,1231,0.8115353371
No,Alabama,1,"Lee County",1081,2230,575,2805,0.7950089127
No,Alabama,1,"Limestone County",1083,2116,449,2565,0.8249512671
No,Alabama,1,"Lowndes County",1085,185,45,230,0.8043478261
No,Alabama,1,"Macon County",1087,240,68,308,0.7792207792
No,Alabama,1,"Madison County",1089,5310,1219,6529,0.8132945321
No,Alabama,1,"Marengo County",1091,503,159,662,0.7598187311
No,Alabama,1,"Marion County",1093,847,222,1069,0.7923292797
No,Alabama,1,"Marshall County",1095,2267,466,2733,0.8294914014
No,Alabama,1,"Mobile County",1097,6203,1525,7728,0.8026656315
No,Alabama,1,"Monroe County",1099,474,152,626,0.7571884984
No,Alabama,1,"Montgomery County",1101,3022,788,3810,0.793175853
No,Alabama,1,"Morgan County",1103,3351,697,4048,0.8278162055
No,Alabama,1,"Perry County",1105,176,54,230,0.7652173913
No,Alabama,1,"Pickens County",1107,450,116,566,0.7950530035
No,Alabama,1,"Pike County",1109,518,139,657,0.7884322679
No,Alabama,1,"Randolph County",1111,578,160,738,0.783197832
No,Alabama,1,"Russell County",1113,796,236,1032,0.7713178295
No,Alabama,1,"St. Clair County",1115,1703,347,2050,0.8307317073
No,Alabama,1,"Shelby County",1117,3998,878,4876,0.8199343724
No,Alabama,1,"Sumter County",1119,262,89,351,0.7464387464
No,Alabama,1,"Talladega County",1121,1859,477,2336,0.7958047945
No,Alabama,1,"Tallapoosa County",1123,1129,296,1425,0.7922807018
No,Alabama,1,"Tuscaloosa County",1125,3887,897,4784,0.8125
No,Alabama,1,"Walker County",1127,1381,342,1723,0.8015089959
No,Alabama,1,"Washington County",1129,438,125,563,0.7779751332
No,Alabama,1,"Wilcox County",1131,235,56,291,0.8075601375
No,Alabama,1,"Winston County",1133,679,141,820,0.8280487805
No,Alabama,1,,1212,.,0,.,1
No,Alabama,1,,1313,0,.,.,0
No,Alabama,1,,1616,.,0,.,1
No,Alabama,1,,1919,.,0,.,1
No,Alabama,1,,1999,40,13,53,0.7547169811
No,Alaska,2,"Aleutians East Borough",2013,.,0,.,1
No,Alaska,2,"Aleutians West Census Area",2016,.,.,.,0.7142857143
No,Alaska,2,"Anchorage Borough",2020,3215,627,3842,0.836803748
No,Alaska,2,"Bethel Census Area",2050,47,16,63,0.746031746
No,Alaska,2,"Bristol Bay Borough",2060,.,.,.,0.5454545455
No,Alaska,2,"Denali Borough (created after 1990)",2068,.,.,.,0.8620689655
No,Alaska,2,"Dillingham Census Area",2070,.,.,.,0.72
No,Alaska,2,"Fairbanks North Star Borough",2090,1067,196,1263,0.8448139351
No,Alaska,2,"Haines Borough",2100,.,.,.,0.875
No,Alaska,2,,2105,.,.,.,0.829787234
No,Alaska,2,"Juneau Borough",2110,589,124,713,0.8260869565
No,Alaska,2,"Kenai Peninsula Borough",2122,1153,231,1384,0.8330924855
No,Alaska,2,"Ketchikan Gateway Borough",2130,283,45,328,0.862804878
No,Alaska,2,"Kodiak Island Borough",2150,90,27,117,0.7692307692
No,Alaska,2,,2158,.,.,.,0.8571428571
No,Alaska,2,"Lake and Peninsula Borough",2164,.,.,.,0.2
No,Alaska,2,"Matanuska-Susitna Borough",2170,1458,313,1771,0.8232636928
No,Alaska,2,"Nome Census Area",2180,.,.,.,0.7142857143
No,Alaska,2,"North Slope Borough",2185,.,.,.,0.8409090909
No,Alaska,2,"Northwest Arctic Borough",2188,22,13,35,0.6285714286
No,Alaska,2,,2195,73,18,91,0.8021978022
No,Alaska,2,,2198,69,21,90,0.7666666667
No,Alaska,2,"Sitka Borough",2220,147,33,180,0.8166666667
No,Alaska,2,,2230,.,.,.,0.8571428571
No,Alaska,2,"Southeast Fairbanks Census Area",2240,92,24,116,0.7931034483
No,Alaska,2,"Valdez-Cordova Census Area",2261,134,21,155,0.864516129
No,Alaska,2,,2275,68,12,80,0.85
No,Alaska,2,"Wrangell-Petersburg Census Area",2280,.,0,.,1
No,Alaska,2,"Yakutat Borough (created after 1990)",2282,.,.,.,0.8181818182
No,Alaska,2,"Yukon-Koyukuk Census Area",2290,.,.,.,0.7777777778
No,Alaska,2,,2525,.,0,.,1
No,Alaska,2,,2727,.,.,.,0.5
No,Alaska,2,,2828,.,0,.,1
No,Alaska,2,,2999,.,.,.,0.9166666667
No,Arizona,4,"Apache County",4001,370,116,486,0.7613168724
No,Arizona,4,"Cochise County",4003,1685,429,2114,0.7970671712
No,Arizona,4,"Coconino County",4005,1328,322,1650,0.8048484848
No,Arizona,4,"Gila County",4007,1716,417,2133,0.8045007032
No,Arizona,4,"Graham County",4009,478,110,588,0.8129251701
No,Arizona,4,"Greenlee County",4011,131,26,157,0.8343949045
No,Arizona,4,"La Paz County",4012,410,103,513,0.7992202729
No,Arizona,4,"Maricopa County",4013,56281,12087,68368,0.8232067634
No,Arizona,4,"Mohave County",4015,6588,1467,8055,0.817877095
No,Arizona,4,"Navajo County",4017,1543,421,1964,0.7856415479
No,Arizona,4,"Pima County",4019,13764,3033,16797,0.8194320414
No,Arizona,4,"Pinal County",4021,6717,1558,8275,0.8117220544
No,Arizona,4,"Santa Cruz County",4023,402,88,490,0.8204081633
No,Arizona,4,"Yavapai County",4025,6871,1523,8394,0.8185608768
No,Arizona,4,"Yuma County",4027,2607,678,3285,0.7936073059
No,Arizona,4,,4040,.,0,.,1
No,Arizona,4,,4141,.,0,.,1
No,Arizona,4,,4545,.,0,.,1
No,Arizona,4,,4747,0,.,.,0
No,Arizona,4,,4848,.,0,.,1
No,Arizona,4,,4999,113,24,137,0.8248175182
No,Arkansas,5,"Arkansas County",5001,483,146,629,0.7678855326
No,Arkansas,5,"Ashley County",5003,720,204,924,0.7792207792
No,Arkansas,5,"Baxter County",5005,1801,391,2192,0.8216240876
No,Arkansas,5,"Benton County",5007,4372,931,5303,0.8244389968
No,Arkansas,5,"Boone County",5009,993,247,1240,0.8008064516
No,Arkansas,5,"Bradley County",5011,286,142,428,0.6682242991
No,Arkansas,5,"Calhoun County",5013,128,54,182,0.7032967033
No,Arkansas,5,"Carroll County",5015,652,165,817,0.7980416157
No,Arkansas,5,"Chicot County",5017,261,89,350,0.7457142857
No,Arkansas,5,"Clark County",5019,448,80,528,0.8484848485
No,Arkansas,5,"Clay County",5021,377,138,515,0.732038835
No,Arkansas,5,"Cleburne County",5023,1014,233,1247,0.8131515638
No,Arkansas,5,"Cleveland County",5025,225,64,289,0.7785467128
No,Arkansas,5,"Columbia County",5027,536,191,727,0.7372764787
No,Arkansas,5,"Conway County",5029,529,143,672,0.787202381
No,Arkansas,5,"Craighead County",5031,1889,480,2369,0.797382862
No,Arkansas,5,"Crawford County",5033,1233,298,1531,0.8053559765
No,Arkansas,5,"Crittenden County",5035,834,266,1100,0.7581818182
No,Arkansas,5,"Cross County",5037,377,121,498,0.7570281124
No,Arkansas,5,"Dallas County",5039,197,68,265,0.7433962264
No,Arkansas,5,"Desha County",5041,320,111,431,0.7424593968
No,Arkansas,5,"Drew County",5043,402,166,568,0.7077464789
No,Arkansas,5,"Faulkner County",5045,2214,530,2744,0.806851312
No,Arkansas,5,"Franklin County",5047,443,105,548,0.8083941606
No,Arkansas,5,"Fulton County",5049,370,113,483,0.7660455487
No,Arkansas,5,"Garland County",5051,2794,800,3594,0.7774067891
No,Arkansas,5,"Grant County",5053,447,112,559,0.7996422182
No,Arkansas,5,"Greene County",5055,972,256,1228,0.7915309446
No,Arkansas,5,"Hempstead County",5057,472,138,610,0.7737704918
No,Arkansas,5,"Hot Spring County",5059,815,226,1041,0.7829010567
No,Arkansas,5,"Howard County",5061,373,116,489,0.7627811861
No,Arkansas,5,"Independence County",5063,1080,283,1363,0.7923697726
No,Arkansas,5,"Izard County",5065,413,141,554,0.7454873646
No,Arkansas,5,"Jackson County",5067,458,117,575,0.7965217391
No,Arkansas,5,"Jefferson County",5069,1302,442,1744,0.746559633
No,Arkansas,5,"Johnson County",5071,538,146,684,0.7865497076
No,Arkansas,5,"Lafayette County",5073,167,60,227,0.7356828194
No,Arkansas,5,"Lawrence County",5075,392,120,512,0.765625
No,Arkansas,5,"Lee County",5077,185,49,234,0.7905982906
No,Arkansas,5,"Lincoln County",5079,246,96,342,0.7192982456
No,Arkansas,5,"Little River County",5081,349,99,448,0.7790178571
No,Arkansas,5,"Logan County",5083,561,123,684,0.8201754386
No,Arkansas,5,"Lonoke County",5085,1365,327,1692,0.8067375887
No,Arkansas,5,"Madison County",5087,334,82,416,0.8028846154
No,Arkansas,5,"Marion County",5089,483,122,605,0.7983471074
No,Arkansas,5,"Miller County",5091,890,237,1127,0.7897071872
No,Arkansas,5,"Mississippi County",5093,710,204,914,0.7768052516
No,Arkansas,5,"Monroe County",5095,211,55,266,0.7932330827
No,Arkansas,5,"Montgomery County",5097,254,51,305,0.8327868852
No,Arkansas,5,"Nevada County",5099,217,69,286,0.7587412587
No,Arkansas,5,"Newton County",5101,161,40,201,0.8009950249
No,Arkansas,5,"Ouachita County",5103,591,195,786,0.7519083969
No,Arkansas,5,"Perry County",5105,271,65,336,0.806547619
No,Arkansas,5,"Phillips County",5107,341,90,431,0.7911832947
No,Arkansas,5,"Pike County",5109,282,85,367,0.7683923706
No,Arkansas,5,"Poinsett County",5111,493,153,646,0.7631578947
No,Arkansas,5,"Polk County",5113,513,162,675,0.76
No,Arkansas,5,"Pope County",5115,1414,314,1728,0.818287037
No,Arkansas,5,"Prairie County",5117,312,85,397,0.7858942065
No,Arkansas,5,"Pulaski County",5119,6867,1978,8845,0.776370831
No,Arkansas,5,"Randolph County",5121,422,144,566,0.7455830389
No,Arkansas,5,"St. Francis County",5123,461,151,612,0.7532679739
No,Arkansas,5,"Saline County",5125,2929,777,3706,0.7903399892
No,Arkansas,5,"Scott County",5127,220,51,271,0.8118081181
No,Arkansas,5,"Searcy County",5129,219,40,259,0.8455598456
No,Arkansas,5,"Sebastian County",5131,2549,599,3148,0.8097204574
No,Arkansas,5,"Sevier County",5133,304,106,410,0.7414634146
No,Arkansas,5,"Sharp County",5135,573,158,731,0.7838577291
No,Arkansas,5,"Stone County",5137,474,136,610,0.7770491803
No,Arkansas,5,"Union County",5139,1076,352,1428,0.7535014006
No,Arkansas,5,"Van Buren County",5141,493,127,620,0.7951612903
No,Arkansas,5,"Washington County",5143,3419,682,4101,0.8336990978
No,Arkansas,5,"White County",5145,2355,498,2853,0.825446898
No,Arkansas,5,"Woodruff County",5147,205,67,272,0.7536764706
No,Arkansas,5,"Yell County",5149,439,133,572,0.7674825175
No,Arkansas,5,,5353,.,0,.,1
No,Arkansas,5,,5555,.,0,.,1
No,Arkansas,5,,5999,39,15,54,0.7222222222
No,California,6,"Alameda County",6001,9934,2175,12109,0.8203815344
No,California,6,"Alpine County",6003,.,.,.,0.8846153846
No,California,6,"Amador County",6005,1336,272,1608,0.8308457711
No,California,6,"Butte County",6007,4426,1083,5509,0.8034125976
No,California,6,"Calaveras County",6009,1558,306,1864,0.8358369099
No,California,6,"Colusa County",6011,361,76,437,0.8260869565
No,California,6,"Contra Costa County",6013,10391,2247,12638,0.8222028802
No,California,6,"Del Norte County",6015,676,129,805,0.8397515528
No,California,6,"El Dorado County",6017,3490,661,4151,0.8407612623
No,California,6,"Fresno County",6019,10157,2371,12528,0.8107439336
No,California,6,"Glenn County",6021,592,122,714,0.8291316527
No,California,6,"Humboldt County",6023,2446,551,2997,0.8161494828
No,California,6,"Imperial County",6025,1742,464,2206,0.7896645512
No,California,6,"Inyo County",6027,439,117,556,0.7895683453
No,California,6,"Kern County",6029,6555,1686,8241,0.795413178
No,California,6,"Kings County",6031,1384,354,1738,0.7963176064
No,California,6,"Lake County",6033,1378,396,1774,0.7767756483
No,California,6,"Lassen County",6035,440,116,556,0.7913669065
No,California,6,"Los Angeles County",6037,58050,15436,73486,0.7899463843
No,California,6,"Madera County",6039,1934,435,2369,0.8163782187
No,California,6,"Marin County",6041,3517,782,4299,0.8180972319
No,California,6,"Mariposa County",6043,496,127,623,0.7961476726
No,California,6,"Mendocino County",6045,1692,397,2089,0.8099569172
No,California,6,"Merced County",6047,2997,838,3835,0.7814863103
No,California,6,"Modoc County",6049,212,50,262,0.8091603053
No,California,6,"Mono County",6051,121,45,166,0.7289156627
No,California,6,"Monterey County",6053,5466,1289,6755,0.8091783864
No,California,6,"Napa County",6055,1919,423,2342,0.8193851409
No,California,6,"Nevada County",6057,2461,633,3094,0.7954104719
No,California,6,"Orange County",6059,27598,6275,33873,0.8147492103
No,California,6,"Placer County",6061,5769,1175,6944,0.8307891705
No,California,6,"Plumas County",6063,554,125,679,0.8159057437
No,California,6,"Riverside County",6065,17808,4198,22006,0.8092338453
No,California,6,"Sacramento County",6067,11340,2601,13941,0.8134280181
No,California,6,"San Benito County",6069,850,190,1040,0.8173076923
No,California,6,"San Bernardino County",6071,10092,2678,12770,0.7902897416
No,California,6,"San Diego County",6073,21434,5042,26476,0.8095633782
No,California,6,"San Francisco County",6075,4586,1052,5638,0.8134090103
No,California,6,"San Joaquin County",6077,7780,1758,9538,0.8156846299
No,California,6,"San Luis Obispo County",6079,6821,1343,8164,0.8354973052
No,California,6,"San Mateo County",6081,7207,1555,8762,0.8225291029
No,California,6,"Santa Barbara County",6083,6042,1362,7404,0.8160453809
No,California,6,"Santa Clara County",6085,13910,2982,16892,0.8234667298
No,California,6,"Santa Cruz County",6087,4267,961,5228,0.8161820964
No,California,6,"Shasta County",6089,4201,952,5153,0.8152532505
No,California,6,"Sierra County",6091,65,16,81,0.8024691358
No,California,6,"Siskiyou County",6093,1212,247,1459,0.830705963
No,California,6,"Solano County",6095,3355,774,4129,0.8125454105
No,California,6,"Sonoma County",6097,5637,1361,6998,0.8055158617
No,California,6,"Stanislaus County",6099,5070,1208,6278,0.8075820325
No,California,6,"Sutter County",6101,1657,374,2031,0.815854259
No,California,6,"Tehama County",6103,1433,365,1798,0.796996663
No,California,6,"Trinity County",6105,290,52,342,0.8479532164
No,California,6,"Tulare County",6107,5450,1319,6769,0.8051410844
No,California,6,"Tuolumne County",6109,1585,384,1969,0.8049771458
No,California,6,"Ventura County",6111,10972,2563,13535,0.8106390839
No,California,6,"Yolo County",6113,1854,365,2219,0.8355114917
No,California,6,"Yuba County",6115,890,241,1131,0.7869142352
No,California,6,,6999,133,49,182,0.7307692308
No,Colorado,8,"Adams County",8001,2473,613,3086,0.8013609851
No,Colorado,8,"Alamosa County",8003,143,40,183,0.781420765
No,Colorado,8,"Arapahoe County",8005,4626,1111,5737,0.8063447795
No,Colorado,8,"Archuleta County",8007,254,54,308,0.8246753247
No,Colorado,8,"Baca County",8009,115,24,139,0.8273381295
No,Colorado,8,"Bent County",8011,50,16,66,0.7575757576
No,Colorado,8,"Boulder County",8013,3027,704,3731,0.8113106406
No,Colorado,8,,8014,621,144,765,0.8117647059
No,Colorado,8,"Chaffee County",8015,418,103,521,0.802303263
No,Colorado,8,"Cheyenne County",8017,41,12,53,0.7735849057
No,Colorado,8,"Clear Creek County",8019,88,19,107,0.8224299065
No,Colorado,8,"Conejos County",8021,85,20,105,0.8095238095
No,Colorado,8,"Costilla County",8023,31,17,48,0.6458333333
No,Colorado,8,"Crowley County",8025,59,13,72,0.8194444444
No,Colorado,8,"Custer County",8027,103,24,127,0.811023622
No,Colorado,8,"Delta County",8029,663,156,819,0.8095238095
No,Colorado,8,"Denver County",8031,3362,938,4300,0.7818604651
No,Colorado,8,"Dolores County",8033,.,.,.,0.7959183673
No,Colorado,8,"Douglas County",8035,3294,794,4088,0.8057729941
No,Colorado,8,"Eagle County",8037,384,88,472,0.813559322
No,Colorado,8,"Elbert County",8039,353,94,447,0.7897091723
No,Colorado,8,"El Paso County",8041,5445,1136,6581,0.8273818569
No,Colorado,8,"Fremont County",8043,807,181,988,0.8168016194
No,Colorado,8,"Garfield County",8045,572,144,716,0.7988826816
No,Colorado,8,"Gilpin County",8047,.,.,.,0.84
No,Colorado,8,"Grand County",8049,166,39,205,0.8097560976
No,Colorado,8,"Gunnison County",8051,157,36,193,0.8134715026
No,Colorado,8,"Hinsdale County",8053,.,.,.,0.8108108108
No,Colorado,8,"Huerfano County",8055,147,35,182,0.8076923077
No,Colorado,8,"Jackson County",8057,.,.,.,0.7352941176
No,Colorado,8,"Jefferson County",8059,4742,1080,5822,0.8144967365
No,Colorado,8,"Kiowa County",8061,.,.,.,0.8139534884
No,Colorado,8,"Kit Carson County",8063,163,29,192,0.8489583333
No,Colorado,8,"Lake County",8065,59,15,74,0.7972972973
No,Colorado,8,"La Plata County",8067,822,183,1005,0.8179104478
No,Colorado,8,"Larimer County",8069,4953,960,5913,0.837645865
No,Colorado,8,"Las Animas County",8071,193,61,254,0.7598425197
No,Colorado,8,"Lincoln County",8073,87,26,113,0.7699115044
No,Colorado,8,"Logan County",8075,434,96,530,0.8188679245
No,Colorado,8,"Mesa County",8077,2168,469,2637,0.8221463785
No,Colorado,8,"Mineral County",8079,.,.,.,0.6875
No,Colorado,8,"Moffat County",8081,184,43,227,0.8105726872
No,Colorado,8,"Montezuma County",8083,488,112,600,0.8133333333
No,Colorado,8,"Montrose County",8085,818,197,1015,0.80591133
No,Colorado,8,"Morgan County",8087,571,119,690,0.8275362319
No,Colorado,8,"Otero County",8089,297,77,374,0.7941176471
No,Colorado,8,"Ouray County",8091,87,17,104,0.8365384615
No,Colorado,8,"Park County",8093,220,60,280,0.7857142857
No,Colorado,8,"Phillips County",8095,135,32,167,0.8083832335
No,Colorado,8,"Pitkin County",8097,162,60,222,0.7297297297
No,Colorado,8,"Prowers County",8099,215,57,272,0.7904411765
No,Colorado,8,"Pueblo County",8101,2238,532,2770,0.8079422383
No,Colorado,8,"Rio Blanco County",8103,106,25,131,0.8091603053
No,Colorado,8,"Rio Grande County",8105,182,40,222,0.8198198198
No,Colorado,8,"Routt County",8107,299,61,360,0.8305555556
No,Colorado,8,"Saguache County",8109,55,25,80,0.6875
No,Colorado,8,"San Juan County",8111,.,.,.,0.8571428571
No,Colorado,8,"San Miguel County",8113,43,16,59,0.7288135593
No,Colorado,8,"Sedgwick County",8115,66,24,90,0.7333333333
No,Colorado,8,"Summit County",8117,222,44,266,0.8345864662
No,Colorado,8,"Teller County",8119,374,71,445,0.8404494382
No,Colorado,8,"Washington County",8121,121,30,151,0.8013245033
No,Colorado,8,"Weld County",8123,3669,762,4431,0.8280297901
No,Colorado,8,"Yuma County",8125,279,57,336,0.8303571429
No,Colorado,8,,8999,.,.,.,0.75
No,Connecticut,9,"Fairfield County",9001,16230,3152,19382,0.8373748839
No,Connecticut,9,"Hartford County",9003,15721,2599,18320,0.8581331878
No,Connecticut,9,"Litchfield County",9005,4382,703,5085,0.8617502458
No,Connecticut,9,"Middlesex County",9007,4007,574,4581,0.8746998472
No,Connecticut,9,"New Haven County",9009,15152,2533,17685,0.8567712751
No,Connecticut,9,"New London County",9011,5778,867,6645,0.8695259594
No,Connecticut,9,"Tolland County",9013,3122,448,3570,0.8745098039
No,Connecticut,9,"Windham County",9015,2408,330,2738,0.8794740687
No,Connecticut,9,,9999,.,.,.,0.8181818182
No,Delaware,10,"Kent County",10001,5307,950,6257,0.8481700495
No,Delaware,10,"New Castle County",10003,13339,2554,15893,0.8393003209
No,Delaware,10,"Sussex County",10005,11578,1980,13558,0.8539607612
No,Delaware,10,,10011,.,0,.,1
No,Delaware,10,,10019,.,0,.,1
No,Delaware,10,,10999,.,.,.,0.8181818182
No,"District of Columbia",11,"District of Columbia",11001,2817,741,3558,0.7917369309
No,"District of Columbia",11,,11999,.,0,.,1
No,Florida,12,"Alachua County",12001,3011,670,3681,0.8179842434
No,Florida,12,"Baker County",12003,382,122,504,0.7579365079
No,Florida,12,"Bay County",12005,3430,861,4291,0.7993474715
No,Florida,12,"Bradford County",12007,485,97,582,0.8333333333
No,Florida,12,"Brevard County",12009,12394,2670,15064,0.82275624
No,Florida,12,"Broward County",12011,18341,4266,22607,0.8112973858
No,Florida,12,"Calhoun County",12013,245,62,307,0.7980456026
No,Florida,12,"Charlotte County",12015,8525,1683,10208,0.8351293103
No,Florida,12,"Citrus County",12017,6328,1356,7684,0.8235294118
No,Florida,12,"Clay County",12019,3313,772,4085,0.8110159119
No,Florida,12,"Collier County",12021,12927,2663,15590,0.8291853752
No,Florida,12,"Columbia County",12023,1079,267,1346,0.8016344725
No,Florida,12,"DeSoto County",12027,776,181,957,0.8108672936
No,Florida,12,"Dixie County",12029,251,74,325,0.7723076923
No,Florida,12,"Duval County",12031,12022,3199,15221,0.7898298404
No,Florida,12,"Escambia County",12033,4325,1086,5411,0.7992977269
No,Florida,12,"Flagler County",12035,3317,703,4020,0.8251243781
No,Florida,12,"Franklin County",12037,261,60,321,0.8130841121
No,Florida,12,"Gadsden County",12039,405,130,535,0.7570093458
No,Florida,12,"Gilchrist County",12041,294,63,357,0.8235294118
No,Florida,12,"Glades County",12043,298,72,370,0.8054054054
No,Florida,12,"Gulf County",12045,462,106,568,0.8133802817
No,Florida,12,"Hamilton County",12047,253,61,314,0.8057324841
No,Florida,12,"Hardee County",12049,405,114,519,0.7803468208
No,Florida,12,"Hendry County",12051,452,111,563,0.8028419183
No,Florida,12,"Hernando County",12053,5374,1099,6473,0.8302178279
No,Florida,12,"Highlands County",12055,3816,854,4670,0.817130621
No,Florida,12,"Hillsborough County",12057,14833,3379,18212,0.8144629914
No,Florida,12,"Holmes County",12059,330,109,439,0.7517084282
No,Florida,12,"Indian River County",12061,6280,1321,7601,0.826207078
No,Florida,12,"Jackson County",12063,895,199,1094,0.8180987203
No,Florida,12,"Jefferson County",12065,180,39,219,0.8219178082
No,Florida,12,"Lafayette County",12067,127,36,163,0.7791411043
No,Florida,12,"Lake County",12069,11412,2374,13786,0.8277963151
No,Florida,12,"Lee County",12071,23458,4658,28116,0.8343292076
No,Florida,12,"Leon County",12073,2077,496,2573,0.8072289157
No,Florida,12,"Levy County",12075,910,221,1131,0.8045977011
No,Florida,12,"Liberty County",12077,99,18,117,0.8461538462
No,Florida,12,"Madison County",12079,358,92,450,0.7955555556
No,Florida,12,"Manatee County",12081,10645,2123,12768,0.8337249373
No,Florida,12,"Marion County",12083,11572,2470,14042,0.8240991312
No,Florida,12,"Martin County",12085,5148,1032,6180,0.8330097087
No,Florida,12,,12086,14079,3695,17774,0.7921120738
No,Florida,12,"Monroe County",12087,1724,387,2111,0.8166745618
No,Florida,12,"Nassau County",12089,2147,495,2642,0.8126419379
No,Florida,12,"Okaloosa County",12091,2396,624,3020,0.7933774834
No,Florida,12,"Okeechobee County",12093,838,236,1074,0.7802607076
No,Florida,12,"Orange County",12095,11892,2880,14772,0.8050365556
No,Florida,12,"Osceola County",12097,3135,785,3920,0.799744898
No,Florida,12,"Palm Beach County",12099,32986,7273,40259,0.8193447428
No,Florida,12,"Pasco County",12101,9995,2000,11995,0.8332638599
No,Florida,12,"Pinellas County",12103,18014,3922,21936,0.8212071481
No,Florida,12,"Polk County",12105,12803,2893,15696,0.815685525
No,Florida,12,"Putnam County",12107,1574,411,1985,0.7929471033
No,Florida,12,"St. Johns County",12109,6499,1312,7811,0.8320317501
No,Florida,12,"St. Lucie County",12111,7685,1584,9269,0.8291077786
No,Florida,12,"Santa Rosa County",12113,2571,609,3180,0.808490566
No,Florida,12,"Sarasota County",12115,18646,3467,22113,0.8432143988
No,Florida,12,"Seminole County",12117,6844,1565,8409,0.8138898799
No,Florida,12,"Sumter County",12119,9597,1786,11383,0.8430993587
No,Florida,12,"Suwannee County",12121,912,214,1126,0.809946714
No,Florida,12,"Taylor County",12123,486,121,607,0.8006589786
No,Florida,12,"Union County",12125,142,24,166,0.8554216867
No,Florida,12,"Volusia County",12127,11128,2456,13584,0.8191990577
No,Florida,12,"Wakulla County",12129,296,83,379,0.7810026385
No,Florida,12,"Walton County",12131,1490,371,1861,0.8006448146
No,Florida,12,"Washington County",12133,527,110,637,0.8273155416
No,Florida,12,,12999,309,73,382,0.8089005236
No,Georgia,13,"Appling County",13001,295,100,395,0.746835443
No,Georgia,13,"Atkinson County",13003,113,37,150,0.7533333333
No,Georgia,13,"Bacon County",13005,215,62,277,0.7761732852
No,Georgia,13,"Baker County",13007,.,.,.,0.8113207547
No,Georgia,13,"Baldwin County",13009,569,157,726,0.7837465565
No,Georgia,13,"Banks County",13011,335,73,408,0.8210784314
No,Georgia,13,"Barrow County",13013,1153,273,1426,0.8085553997
No,Georgia,13,"Bartow County",13015,1845,486,2331,0.7915057915
No,Georgia,13,"Ben Hill County",13017,295,76,371,0.795148248
No,Georgia,13,"Berrien County",13019,257,74,331,0.7764350453
No,Georgia,13,"Bibb County",13021,2162,605,2767,0.7813516444
No,Georgia,13,"Bleckley County",13023,186,51,237,0.7848101266
No,Georgia,13,"Brantley County",13025,297,101,398,0.7462311558
No,Georgia,13,"Brooks County",13027,282,98,380,0.7421052632
No,Georgia,13,"Bryan County",13029,394,96,490,0.8040816327
No,Georgia,13,"Bulloch County",13031,947,308,1255,0.7545816733
No,Georgia,13,"Burke County",13033,299,91,390,0.7666666667
No,Georgia,13,"Butts County",13035,377,98,475,0.7936842105
No,Georgia,13,"Calhoun County",13037,60,22,82,0.7317073171
No,Georgia,13,"Camden County",13039,668,168,836,0.7990430622
No,Georgia,13,"Candler County",13043,175,45,220,0.7954545455
No,Georgia,13,"Carroll County",13045,1892,474,2366,0.7996618766
No,Georgia,13,"Catoosa County",13047,1446,318,1764,0.8197278912
No,Georgia,13,"Charlton County",13049,177,42,219,0.8082191781
No,Georgia,13,"Chatham County",13051,3350,860,4210,0.7957244656
No,Georgia,13,"Chattahoochee County",13053,.,.,.,0.7692307692
No,Georgia,13,"Chattooga County",13055,501,133,634,0.7902208202
No,Georgia,13,"Cherokee County",13057,4240,924,5164,0.8210689388
No,Georgia,13,"Clarke County",13059,1368,326,1694,0.8075560803
No,Georgia,13,"Clay County",13061,.,.,.,0.8524590164
No,Georgia,13,"Clayton County",13063,1580,548,2128,0.742481203
No,Georgia,13,"Clinch County",13065,111,33,144,0.7708333333
No,Georgia,13,"Cobb County",13067,9434,2138,11572,0.8152436917
No,Georgia,13,"Coffee County",13069,680,196,876,0.7762557078
No,Georgia,13,"Colquitt County",13071,680,222,902,0.7538802661
No,Georgia,13,"Columbia County",13073,1752,405,2157,0.8122392211
No,Georgia,13,"Cook County",13075,255,72,327,0.7798165138
No,Georgia,13,"Coweta County",13077,2133,467,2600,0.8203846154
No,Georgia,13,"Crawford County",13079,200,54,254,0.7874015748
No,Georgia,13,"Crisp County",13081,285,88,373,0.764075067
No,Georgia,13,"Dade County",13083,327,71,398,0.8216080402
No,Georgia,13,"Dawson County",13085,560,136,696,0.8045977011
No,Georgia,13,"Decatur County",13087,515,143,658,0.782674772
No,Georgia,13,"DeKalb County",13089,5912,1631,7543,0.7837730346
No,Georgia,13,"Dodge County",13091,288,99,387,0.7441860465
No,Georgia,13,"Dooly County",13093,152,39,191,0.7958115183
No,Georgia,13,"Dougherty County",13095,990,303,1293,0.7656612529
No,Georgia,13,"Douglas County",13097,1695,458,2153,0.7872735718
No,Georgia,13,"Early County",13099,213,29,242,0.8801652893
No,Georgia,13,"Echols County",13101,71,11,82,0.8658536585
No,Georgia,13,"Effingham County",13103,817,203,1020,0.8009803922
No,Georgia,13,"Elbert County",13105,402,82,484,0.8305785124
No,Georgia,13,"Emanuel County",13107,307,102,409,0.7506112469
No,Georgia,13,"Evans County",13109,172,24,196,0.8775510204
No,Georgia,13,"Fannin County",13111,859,198,1057,0.8126773888
No,Georgia,13,"Fayette County",13113,2046,512,2558,0.7998436278
No,Georgia,13,"Floyd County",13115,2126,592,2718,0.7821927888
No,Georgia,13,"Forsyth County",13117,3466,744,4210,0.8232779097
No,Georgia,13,"Franklin County",13119,494,136,630,0.7841269841
No,Georgia,13,"Fulton County",13121,9189,2370,11559,0.7949649624
No,Georgia,13,"Gilmer County",13123,885,207,1092,0.8104395604
No,Georgia,13,"Glascock County",13125,43,22,65,0.6615384615
No,Georgia,13,"Glynn County",13127,1688,416,2104,0.8022813688
No,Georgia,13,"Gordon County",13129,1070,304,1374,0.7787481805
No,Georgia,13,"Grady County",13131,385,134,519,0.7418111753
No,Georgia,13,"Greene County",13133,595,143,738,0.8062330623
No,Georgia,13,"Gwinnett County",13135,7875,1906,9781,0.8051323996
No,Georgia,13,"Habersham County",13137,981,207,1188,0.8257575758
No,Georgia,13,"Hall County",13139,3859,931,4790,0.8056367432
No,Georgia,13,"Hancock County",13141,133,51,184,0.722826087
No,Georgia,13,"Haralson County",13143,603,171,774,0.7790697674
No,Georgia,13,"Harris County",13145,563,157,720,0.7819444444
No,Georgia,13,"Hart County",13147,639,178,817,0.782129743
No,Georgia,13,"Heard County",13149,182,41,223,0.8161434978
No,Georgia,13,"Henry County",13151,2649,702,3351,0.7905102954
No,Georgia,13,"Houston County",13153,1301,346,1647,0.7899210686
No,Georgia,13,"Irwin County",13155,172,39,211,0.8151658768
No,Georgia,13,"Jackson County",13157,1382,290,1672,0.8265550239
No,Georgia,13,"Jasper County",13159,245,63,308,0.7954545455
No,Georgia,13,"Jeff Davis County",13161,253,73,326,0.7760736196
No,Georgia,13,"Jefferson County",13163,294,111,405,0.7259259259
No,Georgia,13,"Jenkins County",13165,121,34,155,0.7806451613
No,Georgia,13,"Johnson County",13167,162,43,205,0.7902439024
No,Georgia,13,"Jones County",13169,513,132,645,0.7953488372
No,Georgia,13,"Lamar County",13171,259,62,321,0.8068535826
No,Georgia,13,"Lanier County",13173,134,39,173,0.774566474
No,Georgia,13,"Laurens County",13175,807,260,1067,0.7563261481
No,Georgia,13,"Lee County",13177,379,92,471,0.804670913
No,Georgia,13,"Liberty County",13179,259,84,343,0.7551020408
No,Georgia,13,"Lincoln County",13181,164,34,198,0.8282828283
No,Georgia,13,"Long County",13183,64,26,90,0.7111111111
No,Georgia,13,"Lowndes County",13185,1449,405,1854,0.7815533981
No,Georgia,13,"Lumpkin County",13187,680,148,828,0.8212560386
No,Georgia,13,"McDuffie County",13189,341,77,418,0.8157894737
No,Georgia,13,"McIntosh County",13191,246,64,310,0.7935483871
No,Georgia,13,"Macon County",13193,159,47,206,0.7718446602
No,Georgia,13,"Madison County",13195,588,152,740,0.7945945946
No,Georgia,13,"Marion County",13197,107,29,136,0.7867647059
No,Georgia,13,"Meriwether County",13199,401,87,488,0.8217213115
No,Georgia,13,"Miller County",13201,113,31,144,0.7847222222
No,Georgia,13,"Mitchell County",13205,296,79,375,0.7893333333
No,Georgia,13,"Monroe County",13207,511,135,646,0.7910216718
No,Georgia,13,"Montgomery County",13209,123,35,158,0.7784810127
No,Georgia,13,"Morgan County",13211,430,111,541,0.7948243993
No,Georgia,13,"Murray County",13213,733,203,936,0.7831196581
No,Georgia,13,"Muscogee County",13215,1849,523,2372,0.7795109612
No,Georgia,13,"Newton County",13217,1530,381,1911,0.8006279435
No,Georgia,13,"Oconee County",13219,750,140,890,0.8426966292
No,Georgia,13,"Oglethorpe County",13221,317,63,380,0.8342105263
No,Georgia,13,"Paulding County",13223,2131,541,2672,0.7975299401
No,Georgia,13,"Peach County",13225,386,89,475,0.8126315789
No,Georgia,13,"Pickens County",13227,1080,243,1323,0.8163265306
No,Georgia,13,"Pierce County",13229,439,121,560,0.7839285714
No,Georgia,13,"Pike County",13231,237,70,307,0.7719869707
No,Georgia,13,"Polk County",13233,831,258,1089,0.7630853994
No,Georgia,13,"Pulaski County",13235,156,53,209,0.7464114833
No,Georgia,13,"Putnam County",13237,610,131,741,0.8232118758
No,Georgia,13,"Quitman County",13239,51,12,63,0.8095238095
No,Georgia,13,"Rabun County",13241,614,163,777,0.7902187902
No,Georgia,13,"Randolph County",13243,91,23,114,0.798245614
No,Georgia,13,"Richmond County",13245,1988,547,2535,0.7842209073
No,Georgia,13,"Rockdale County",13247,1271,327,1598,0.7953692115
No,Georgia,13,"Schley County",13249,65,18,83,0.7831325301
No,Georgia,13,"Screven County",13251,247,61,308,0.8019480519
No,Georgia,13,"Seminole County",13253,197,54,251,0.7848605578
No,Georgia,13,"Spalding County",13255,1116,334,1450,0.7696551724
No,Georgia,13,"Stephens County",13257,646,199,845,0.7644970414
No,Georgia,13,"Stewart County",13259,65,12,77,0.8441558442
No,Georgia,13,"Sumter County",13261,473,118,591,0.8003384095
No,Georgia,13,"Talbot County",13263,105,44,149,0.7046979866
No,Georgia,13,"Taliaferro County",13265,.,.,.,0.7272727273
No,Georgia,13,"Tattnall County",13267,208,62,270,0.7703703704
No,Georgia,13,"Taylor County",13269,102,33,135,0.7555555556
No,Georgia,13,"Telfair County",13271,169,70,239,0.7071129707
No,Georgia,13,"Terrell County",13273,124,28,152,0.8157894737
No,Georgia,13,"Thomas County",13275,798,212,1010,0.7900990099
No,Georgia,13,"Tift County",13277,516,160,676,0.7633136095
No,Georgia,13,"Toombs County",13279,374,111,485,0.7711340206
No,Georgia,13,"Towns County",13281,528,103,631,0.8367670365
No,Georgia,13,"Treutlen County",13283,101,29,130,0.7769230769
No,Georgia,13,"Troup County",13285,1106,281,1387,0.7974044701
No,Georgia,13,"Turner County",13287,114,31,145,0.7862068966
No,Georgia,13,"Twiggs County",13289,163,54,217,0.7511520737
No,Georgia,13,"Union County",13291,936,210,1146,0.8167539267
No,Georgia,13,"Upson County",13293,438,118,556,0.7877697842
No,Georgia,13,"Walker County",13295,1387,331,1718,0.8073341094
No,Georgia,13,"Walton County",13297,1794,413,2207,0.8128681468
No,Georgia,13,"Ware County",13299,754,230,984,0.7662601626
No,Georgia,13,"Warren County",13301,97,26,123,0.7886178862
No,Georgia,13,"Washington County",13303,367,78,445,0.8247191011
No,Georgia,13,"Wayne County",13305,512,149,661,0.7745839637
No,Georgia,13,"Webster County",13307,.,.,.,0.8214285714
No,Georgia,13,"Wheeler County",13309,65,22,87,0.7471264368
No,Georgia,13,"White County",13311,782,183,965,0.8103626943
No,Georgia,13,"Whitfield County",13313,1624,445,2069,0.7849202513
No,Georgia,13,"Wilcox County",13315,106,39,145,0.7310344828
No,Georgia,13,"Wilkes County",13317,225,62,287,0.7839721254
No,Georgia,13,"Wilkinson County",13319,210,60,270,0.7777777778
No,Georgia,13,"Worth County",13321,320,96,416,0.7692307692
No,Georgia,13,,13999,69,18,87,0.7931034483
No,Hawaii,15,"Hawaii County",15001,3066,608,3674,0.8345127926
No,Hawaii,15,"Honolulu County",15003,8036,1504,9540,0.8423480084
No,Hawaii,15,"Kauai County",15007,980,201,1181,0.8298052498
No,Hawaii,15,"Maui County",15009,1431,352,1783,0.8025799215
No,Hawaii,15,,15999,.,.,.,0.75
No,Idaho,16,"Ada County",16001,4766,861,5627,0.8469877377
No,Idaho,16,"Adams County",16003,104,19,123,0.8455284553
No,Idaho,16,"Bannock County",16005,976,253,1229,0.7941415785
No,Idaho,16,"Bear Lake County",16007,145,35,180,0.8055555556
No,Idaho,16,"Benewah County",16009,203,45,248,0.8185483871
No,Idaho,16,"Bingham County",16011,581,173,754,0.7705570292
No,Idaho,16,"Blaine County",16013,350,97,447,0.7829977629
No,Idaho,16,"Boise County",16015,111,22,133,0.8345864662
No,Idaho,16,"Bonner County",16017,864,225,1089,0.7933884298
No,Idaho,16,"Bonneville County",16019,1557,393,1950,0.7984615385
No,Idaho,16,"Boundary County",16021,199,51,250,0.796
No,Idaho,16,"Butte County",16023,66,13,79,0.835443038
No,Idaho,16,"Camas County",16025,.,.,.,0.7741935484
No,Idaho,16,"Canyon County",16027,2163,469,2632,0.8218085106
No,Idaho,16,"Caribou County",16029,191,37,228,0.8377192982
No,Idaho,16,"Cassia County",16031,317,94,411,0.7712895377
No,Idaho,16,"Clark County",16033,.,.,.,0.7692307692
No,Idaho,16,"Clearwater County",16035,259,56,315,0.8222222222
No,Idaho,16,"Custer County",16037,119,20,139,0.8561151079
No,Idaho,16,"Elmore County",16039,234,50,284,0.823943662
No,Idaho,16,"Franklin County",16041,261,69,330,0.7909090909
No,Idaho,16,"Fremont County",16043,220,52,272,0.8088235294
No,Idaho,16,"Gem County",16045,262,53,315,0.8317460317
No,Idaho,16,"Gooding County",16047,267,64,331,0.8066465257
No,Idaho,16,"Idaho County",16049,431,88,519,0.8304431599
No,Idaho,16,"Jefferson County",16051,336,91,427,0.7868852459
No,Idaho,16,"Jerome County",16053,282,58,340,0.8294117647
No,Idaho,16,"Kootenai County",16055,2973,653,3626,0.8199117485
No,Idaho,16,"Latah County",16057,557,106,663,0.8401206637
No,Idaho,16,"Lemhi County",16059,226,42,268,0.8432835821
No,Idaho,16,"Lewis County",16061,110,31,141,0.780141844
No,Idaho,16,"Lincoln County",16063,.,.,.,0.8684210526
No,Idaho,16,"Madison County",16065,349,80,429,0.8135198135
No,Idaho,16,"Minidoka County",16067,313,67,380,0.8236842105
No,Idaho,16,"Nez Perce County",16069,930,230,1160,0.8017241379
No,Idaho,16,"Oneida County",16071,88,26,114,0.7719298246
No,Idaho,16,"Owyhee County",16073,108,26,134,0.8059701493
No,Idaho,16,"Payette County",16075,471,106,577,0.8162911612
No,Idaho,16,"Power County",16077,140,20,160,0.875
No,Idaho,16,"Shoshone County",16079,427,90,517,0.8259187621
No,Idaho,16,"Teton County",16081,108,19,127,0.8503937008
No,Idaho,16,"Twin Falls County",16083,1368,258,1626,0.8413284133
No,Idaho,16,"Valley County",16085,195,43,238,0.8193277311
No,Idaho,16,"Washington County",16087,244,55,299,0.8160535117
No,Idaho,16,,16999,.,.,.,0.8333333333
No,Illinois,17,"Adams County",17001,2477,399,2876,0.8612656467
No,Illinois,17,"Alexander County",17003,162,39,201,0.8059701493
No,Illinois,17,"Bond County",17005,656,111,767,0.8552803129
No,Illinois,17,"Boone County",17007,1378,235,1613,0.8543087415
No,Illinois,17,"Brown County",17009,173,31,204,0.8480392157
No,Illinois,17,"Bureau County",17011,1341,216,1557,0.8612716763
No,Illinois,17,"Calhoun County",17013,225,45,270,0.8333333333
No,Illinois,17,"Carroll County",17015,653,115,768,0.8502604167
No,Illinois,17,"Cass County",17017,433,78,511,0.8473581213
No,Illinois,17,"Champaign County",17019,3293,572,3865,0.8520051746
No,Illinois,17,"Christian County",17021,1272,241,1513,0.8407138136
No,Illinois,17,"Clark County",17023,640,120,760,0.8421052632
No,Illinois,17,"Clay County",17025,599,80,679,0.882179676
No,Illinois,17,"Clinton County",17027,1202,222,1424,0.8441011236
No,Illinois,17,"Coles County",17029,1643,261,1904,0.8629201681
No,Illinois,17,"Cook County",17031,85607,17882,103489,0.8272086888
No,Illinois,17,"Crawford County",17033,864,157,1021,0.8462291871
No,Illinois,17,"Cumberland County",17035,471,64,535,0.8803738318
No,Illinois,17,"DeKalb County",17037,2548,404,2952,0.8631436314
No,Illinois,17,"De Witt County",17039,589,71,660,0.8924242424
No,Illinois,17,"Douglas County",17041,613,105,718,0.8537604457
No,Illinois,17,"DuPage County",17043,22596,3933,26529,0.8517471446
No,Illinois,17,"Edgar County",17045,789,160,949,0.8314014752
No,Illinois,17,"Edwards County",17047,256,45,301,0.8504983389
No,Illinois,17,"Effingham County",17049,1476,254,1730,0.8531791908
No,Illinois,17,"Fayette County",17051,733,140,873,0.8396334479
No,Illinois,17,"Ford County",17053,424,89,513,0.8265107212
No,Illinois,17,"Franklin County",17055,1249,241,1490,0.8382550336
No,Illinois,17,"Fulton County",17057,958,145,1103,0.8685403445
No,Illinois,17,"Gallatin County",17059,193,41,234,0.8247863248
No,Illinois,17,"Greene County",17061,535,97,632,0.8465189873
No,Illinois,17,"Grundy County",17063,1304,214,1518,0.8590250329
No,Illinois,17,"Hamilton County",17065,308,34,342,0.9005847953
No,Illinois,17,"Hancock County",17067,792,109,901,0.8790233074
No,Illinois,17,"Hardin County",17069,145,22,167,0.8682634731
No,Illinois,17,"Henderson County",17071,282,53,335,0.8417910448
No,Illinois,17,"Henry County",17073,1978,257,2235,0.8850111857
No,Illinois,17,"Iroquois County",17075,1203,192,1395,0.8623655914
No,Illinois,17,"Jackson County",17077,1323,290,1613,0.8202107874
No,Illinois,17,"Jasper County",17079,433,71,504,0.8591269841
No,Illinois,17,"Jefferson County",17081,1302,226,1528,0.8520942408
No,Illinois,17,"Jersey County",17083,911,208,1119,0.8141197498
No,Illinois,17,"Jo Daviess County",17085,712,114,826,0.8619854722
No,Illinois,17,"Johnson County",17087,451,76,527,0.8557874763
No,Illinois,17,"Kane County",17089,11883,2042,13925,0.8533572711
No,Illinois,17,"Kankakee County",17091,3251,618,3869,0.8402688033
No,Illinois,17,"Kendall County",17093,2372,375,2747,0.8634874408
No,Illinois,17,"Knox County",17095,1707,271,1978,0.8629929221
No,Illinois,17,"Lake County",17097,15687,2784,18471,0.8492772454
No,Illinois,17,"La Salle County",17099,3781,605,4386,0.8620611035
No,Illinois,17,"Lawrence County",17101,494,90,584,0.845890411
No,Illinois,17,"Lee County",17103,1347,224,1571,0.8574156588
No,Illinois,17,"Livingston County",17105,1303,185,1488,0.875672043
No,Illinois,17,"Logan County",17107,1031,163,1194,0.8634840871
No,Illinois,17,"McDonough County",17109,944,151,1095,0.8621004566
No,Illinois,17,"McHenry County",17111,9371,1661,11032,0.8494379985
No,Illinois,17,"McLean County",17113,4111,602,4713,0.8722681944
No,Illinois,17,"Macon County",17115,4231,819,5050,0.8378217822
No,Illinois,17,"Macoupin County",17117,1921,348,2269,0.8466284707
No,Illinois,17,"Madison County",17119,7193,1365,8558,0.8405001168
No,Illinois,17,"Marion County",17121,1416,322,1738,0.8147295742
No,Illinois,17,"Marshall County",17123,438,67,505,0.8673267327
No,Illinois,17,"Mason County",17125,476,88,564,0.8439716312
No,Illinois,17,"Massac County",17127,511,80,591,0.8646362098
No,Illinois,17,"Menard County",17129,464,98,562,0.8256227758
No,Illinois,17,"Mercer County",17131,600,100,700,0.8571428571
No,Illinois,17,"Monroe County",17133,1027,182,1209,0.8494623656
No,Illinois,17,"Montgomery County",17135,1151,194,1345,0.8557620818
No,Illinois,17,"Morgan County",17137,1297,217,1514,0.85667107
No,Illinois,17,"Moultrie County",17139,580,114,694,0.8357348703
No,Illinois,17,"Ogle County",17141,1666,273,1939,0.8592057762
No,Illinois,17,"Peoria County",17143,3991,667,4658,0.8568054959
No,Illinois,17,"Perry County",17145,641,128,769,0.833550065
No,Illinois,17,"Piatt County",17147,543,89,632,0.8591772152
No,Illinois,17,"Pike County",17149,604,122,726,0.8319559229
No,Illinois,17,"Pope County",17151,158,23,181,0.8729281768
No,Illinois,17,"Pulaski County",17153,162,43,205,0.7902439024
No,Illinois,17,"Putnam County",17155,231,39,270,0.8555555556
No,Illinois,17,"Randolph County",17157,1188,221,1409,0.843151171
No,Illinois,17,"Richland County",17159,623,106,729,0.8545953361
No,Illinois,17,"Rock Island County",17161,4343,655,4998,0.868947579
No,Illinois,17,"St. Clair County",17163,4989,1023,6012,0.8298403194
No,Illinois,17,"Saline County",17165,786,169,955,0.8230366492
No,Illinois,17,"Sangamon County",17167,6475,1197,7672,0.8439781022
No,Illinois,17,"Schuyler County",17169,318,57,375,0.848
No,Illinois,17,"Scott County",17171,186,32,218,0.8532110092
No,Illinois,17,"Shelby County",17173,1006,163,1169,0.8605645851
No,Illinois,17,"Stark County",17175,175,29,204,0.8578431373
No,Illinois,17,"Stephenson County",17177,1560,260,1820,0.8571428571
No,Illinois,17,"Tazewell County",17179,3751,567,4318,0.868689208
No,Illinois,17,"Union County",17181,598,121,719,0.8317107093
No,Illinois,17,"Vermilion County",17183,2165,408,2573,0.8414302371
No,Illinois,17,"Wabash County",17185,491,80,571,0.8598949212
No,Illinois,17,"Warren County",17187,629,90,719,0.8748261474
No,Illinois,17,"Washington County",17189,584,118,702,0.8319088319
No,Illinois,17,"Wayne County",17191,607,115,722,0.8407202216
No,Illinois,17,"White County",17193,534,107,641,0.8330733229
No,Illinois,17,"Whiteside County",17195,2531,382,2913,0.8688637144
No,Illinois,17,"Will County",17197,14976,2683,17659,0.8480661419
No,Illinois,17,"Williamson County",17199,2110,478,2588,0.815301391
No,Illinois,17,"Winnebago County",17201,7475,1245,8720,0.8572247706
No,Illinois,17,"Woodford County",17203,1263,178,1441,0.8764746704
No,Illinois,17,,17999,105,18,123,0.8536585366
No,Indiana,18,"Adams County",18001,894,131,1025,0.872195122
No,Indiana,18,"Allen County",18003,5954,1168,7122,0.8360011233
No,Indiana,18,"Bartholomew County",18005,2253,402,2655,0.8485875706
No,Indiana,18,"Benton County",18007,258,55,313,0.8242811502
No,Indiana,18,"Blackford County",18009,461,60,521,0.8848368522
No,Indiana,18,"Boone County",18011,1655,289,1944,0.8513374486
No,Indiana,18,"Brown County",18013,459,89,548,0.8375912409
No,Indiana,18,"Carroll County",18015,645,121,766,0.8420365535
No,Indiana,18,"Cass County",18017,1229,205,1434,0.8570432357
No,Indiana,18,"Clark County",18019,2558,580,3138,0.8151688974
No,Indiana,18,"Clay County",18021,925,192,1117,0.8281110116
No,Indiana,18,"Clinton County",18023,986,159,1145,0.8611353712
No,Indiana,18,"Crawford County",18025,281,52,333,0.8438438438
No,Indiana,18,"Daviess County",18027,632,131,763,0.8283093054
No,Indiana,18,"Dearborn County",18029,1298,241,1539,0.8434048083
No,Indiana,18,"Decatur County",18031,827,138,965,0.8569948187
No,Indiana,18,"De Kalb County",18033,834,160,994,0.8390342052
No,Indiana,18,"Delaware County",18035,3353,637,3990,0.8403508772
No,Indiana,18,"Dubois County",18037,1535,182,1717,0.8940011648
No,Indiana,18,"Elkhart County",18039,3697,711,4408,0.8387023593
No,Indiana,18,"Fayette County",18041,972,171,1143,0.8503937008
No,Indiana,18,"Floyd County",18043,1957,421,2378,0.822960471
No,Indiana,18,"Fountain County",18045,659,128,787,0.8373570521
No,Indiana,18,"Franklin County",18047,598,115,713,0.8387096774
No,Indiana,18,"Fulton County",18049,598,103,701,0.8530670471
No,Indiana,18,"Gibson County",18051,942,142,1084,0.86900369
No,Indiana,18,"Grant County",18053,2148,399,2547,0.8433451119
No,Indiana,18,"Greene County",18055,872,157,1029,0.8474246842
No,Indiana,18,"Hamilton County",18057,6111,1036,7147,0.8550440744
No,Indiana,18,"Hancock County",18059,2113,324,2437,0.8670496512
No,Indiana,18,"Harrison County",18061,1066,236,1302,0.8187403994
No,Indiana,18,"Hendricks County",18063,3803,698,4501,0.8449233504
No,Indiana,18,"Henry County",18065,1773,290,2063,0.8594280175
No,Indiana,18,"Howard County",18067,3015,557,3572,0.8440649496
No,Indiana,18,"Huntington County",18069,842,155,997,0.8445336008
No,Indiana,18,"Jackson County",18071,1368,209,1577,0.8674698795
No,Indiana,18,"Jasper County",18073,1172,209,1381,0.848660391
No,Indiana,18,"Jay County",18075,597,107,704,0.8480113636
No,Indiana,18,"Jefferson County",18077,973,210,1183,0.8224852071
No,Indiana,18,"Jennings County",18079,791,151,942,0.8397027601
No,Indiana,18,"Johnson County",18081,3991,676,4667,0.8551532033
No,Indiana,18,"Knox County",18083,1053,184,1237,0.8512530315
No,Indiana,18,"Kosciusko County",18085,1728,318,2046,0.8445747801
No,Indiana,18,"Lagrange County",18087,584,113,697,0.8378766141
No,Indiana,18,"Lake County",18089,13513,2941,16454,0.8212592683
No,Indiana,18,"La Porte County",18091,3332,664,3996,0.8338338338
No,Indiana,18,"Lawrence County",18093,1416,275,1691,0.8373743347
No,Indiana,18,"Madison County",18095,4255,706,4961,0.8576899819
No,Indiana,18,"Marion County",18097,13661,2840,16501,0.8278892188
No,Indiana,18,"Marshall County",18099,1152,191,1343,0.8577810871
No,Indiana,18,"Martin County",18101,257,33,290,0.8862068966
No,Indiana,18,"Miami County",18103,1006,165,1171,0.8590947908
No,Indiana,18,"Monroe County",18105,2491,478,2969,0.8390030313
No,Indiana,18,"Montgomery County",18107,1128,211,1339,0.8424197162
No,Indiana,18,"Morgan County",18109,2097,399,2496,0.8401442308
No,Indiana,18,"Newton County",18111,473,81,554,0.8537906137
No,Indiana,18,"Noble County",18113,958,149,1107,0.8654019874
No,Indiana,18,"Ohio County",18115,164,36,200,0.82
No,Indiana,18,"Orange County",18117,552,81,633,0.8720379147
No,Indiana,18,"Owen County",18119,606,135,741,0.8178137652
No,Indiana,18,"Parke County",18121,621,123,744,0.8346774194
No,Indiana,18,"Perry County",18123,594,124,718,0.8272980501
No,Indiana,18,"Pike County",18125,373,58,431,0.8654292343
No,Indiana,18,"Porter County",18127,5203,995,6198,0.8394643433
No,Indiana,18,"Posey County",18129,894,152,1046,0.8546845124
No,Indiana,18,"Pulaski County",18131,479,75,554,0.8646209386
No,Indiana,18,"Putnam County",18133,1102,208,1310,0.841221374
No,Indiana,18,"Randolph County",18135,920,157,1077,0.8542246982
No,Indiana,18,"Ripley County",18137,829,133,962,0.8617463617
No,Indiana,18,"Rush County",18139,589,91,680,0.8661764706
No,Indiana,18,"St. Joseph County",18141,5170,887,6057,0.8535578669
No,Indiana,18,"Scott County",18143,693,175,868,0.7983870968
No,Indiana,18,"Shelby County",18145,1228,258,1486,0.8263795424
No,Indiana,18,"Spencer County",18147,605,124,729,0.8299039781
No,Indiana,18,"Starke County",18149,820,134,954,0.8595387841
No,Indiana,18,"Steuben County",18151,943,168,1111,0.8487848785
No,Indiana,18,"Sullivan County",18153,725,140,865,0.838150289
No,Indiana,18,"Switzerland County",18155,250,41,291,0.8591065292
No,Indiana,18,"Tippecanoe County",18157,3336,565,3901,0.8551653422
No,Indiana,18,"Tipton County",18159,673,98,771,0.8728923476
No,Indiana,18,"Union County",18161,266,30,296,0.8986486486
No,Indiana,18,"Vanderburgh County",18163,4287,817,5104,0.8399294671
No,Indiana,18,"Vermillion County",18165,640,127,767,0.8344198175
No,Indiana,18,"Vigo County",18167,3160,740,3900,0.8102564103
No,Indiana,18,"Wabash County",18169,930,159,1089,0.8539944904
No,Indiana,18,"Warren County",18171,322,64,386,0.8341968912
No,Indiana,18,"Warrick County",18173,1676,308,1984,0.8447580645
No,Indiana,18,"Washington County",18175,694,149,843,0.8232502966
No,Indiana,18,"Wayne County",18177,2117,440,2557,0.8279233477
No,Indiana,18,"Wells County",18179,716,112,828,0.8647342995
No,Indiana,18,"White County",18181,951,163,1114,0.8536804309
No,Indiana,18,"Whitley County",18183,710,101,811,0.8754623921
No,Indiana,18,,18999,75,18,93,0.8064516129
No,Iowa,19,"Adair County",19001,299,46,345,0.8666666667
No,Iowa,19,"Adams County",19003,164,13,177,0.9265536723
No,Iowa,19,"Allamakee County",19005,602,86,688,0.875
No,Iowa,19,"Appanoose County",19007,471,87,558,0.8440860215
No,Iowa,19,"Audubon County",19009,342,45,387,0.8837209302
No,Iowa,19,"Benton County",19011,948,138,1086,0.8729281768
No,Iowa,19,"Black Hawk County",19013,4284,620,4904,0.8735725938
No,Iowa,19,"Boone County",19015,924,143,1067,0.8659793814
No,Iowa,19,"Bremer County",19017,1156,162,1318,0.8770864947
No,Iowa,19,"Buchanan County",19019,865,117,982,0.8808553971
No,Iowa,19,"Buena Vista County",19021,539,82,621,0.8679549114
No,Iowa,19,"Butler County",19023,779,120,899,0.8665183537
No,Iowa,19,"Calhoun County",19025,454,68,522,0.8697318008
No,Iowa,19,"Carroll County",19027,958,119,1077,0.8895078923
No,Iowa,19,"Cass County",19029,697,75,772,0.9028497409
No,Iowa,19,"Cedar County",19031,596,102,698,0.8538681948
No,Iowa,19,"Cerro Gordo County",19033,1851,302,2153,0.8597306085
No,Iowa,19,"Cherokee County",19035,497,55,552,0.9003623188
No,Iowa,19,"Chickasaw County",19037,524,72,596,0.8791946309
No,Iowa,19,"Clarke County",19039,319,57,376,0.8484042553
No,Iowa,19,"Clay County",19041,741,84,825,0.8981818182
No,Iowa,19,"Clayton County",19043,724,100,824,0.8786407767
No,Iowa,19,"Clinton County",19045,1839,258,2097,0.8769670959
No,Iowa,19,"Crawford County",19047,626,80,706,0.8866855524
No,Iowa,19,"Dallas County",19049,1794,268,2062,0.870029098
No,Iowa,19,"Davis County",19051,294,53,347,0.8472622478
No,Iowa,19,"Decatur County",19053,264,39,303,0.8712871287
No,Iowa,19,"Delaware County",19055,656,116,772,0.8497409326
No,Iowa,19,"Des Moines County",19057,1668,220,1888,0.8834745763
No,Iowa,19,"Dickinson County",19059,990,118,1108,0.8935018051
No,Iowa,19,"Dubuque County",19061,2084,287,2371,0.8789540278
No,Iowa,19,"Emmet County",19063,483,64,547,0.8829981718
No,Iowa,19,"Fayette County",19065,897,123,1020,0.8794117647
No,Iowa,19,"Floyd County",19067,710,93,803,0.8841843088
No,Iowa,19,"Franklin County",19069,455,75,530,0.858490566
No,Iowa,19,"Fremont County",19071,303,68,371,0.8167115903
No,Iowa,19,"Greene County",19073,413,51,464,0.8900862069
No,Iowa,19,"Grundy County",19075,591,86,677,0.8729689808
No,Iowa,19,"Guthrie County",19077,438,58,496,0.8830645161
No,Iowa,19,"Hamilton County",19079,658,92,750,0.8773333333
No,Iowa,19,"Hancock County",19081,546,62,608,0.8980263158
No,Iowa,19,"Hardin County",19083,748,92,840,0.8904761905
No,Iowa,19,"Harrison County",19085,541,90,631,0.8573692552
No,Iowa,19,"Henry County",19087,790,124,914,0.8643326039
No,Iowa,19,"Howard County",19089,469,54,523,0.896749522
No,Iowa,19,"Humboldt County",19091,399,56,455,0.8769230769
No,Iowa,19,"Ida County",19093,258,44,302,0.8543046358
No,Iowa,19,"Iowa County",19095,648,67,715,0.9062937063
No,Iowa,19,"Jackson County",19097,667,108,775,0.8606451613
No,Iowa,19,"Jasper County",19099,1251,199,1450,0.8627586207
No,Iowa,19,"Jefferson County",19101,540,88,628,0.8598726115
No,Iowa,19,"Johnson County",19103,2333,328,2661,0.8767380684
No,Iowa,19,"Jones County",19105,826,114,940,0.8787234043
No,Iowa,19,"Keokuk County",19107,387,58,445,0.8696629213
No,Iowa,19,"Kossuth County",19109,736,81,817,0.9008567931
No,Iowa,19,"Lee County",19111,1448,222,1670,0.8670658683
No,Iowa,19,"Linn County",19113,6290,877,7167,0.8776335984
No,Iowa,19,"Louisa County",19115,386,53,439,0.8792710706
No,Iowa,19,"Lucas County",19117,331,50,381,0.8687664042
No,Iowa,19,"Lyon County",19119,437,60,497,0.8792756539
No,Iowa,19,"Madison County",19121,426,73,499,0.8537074148
No,Iowa,19,"Mahaska County",19123,685,101,786,0.8715012723
No,Iowa,19,"Marion County",19125,1089,171,1260,0.8642857143
No,Iowa,19,"Marshall County",19127,1344,196,1540,0.8727272727
No,Iowa,19,"Mills County",19129,462,73,535,0.8635514019
No,Iowa,19,"Mitchell County",19131,470,78,548,0.8576642336
No,Iowa,19,"Monona County",19133,408,57,465,0.8774193548
No,Iowa,19,"Monroe County",19135,301,45,346,0.8699421965
No,Iowa,19,"Montgomery County",19137,467,94,561,0.8324420677
No,Iowa,19,"Muscatine County",19139,1308,196,1504,0.8696808511
No,Iowa,19,O,19141,630,82,712,0.8848314607
No,Iowa,19,"Osceola County",19143,263,37,300,0.8766666667
No,Iowa,19,"Page County",19145,698,114,812,0.8596059113
No,Iowa,19,"Palo Alto County",19147,467,53,520,0.8980769231
No,Iowa,19,"Plymouth County",19149,922,118,1040,0.8865384615
No,Iowa,19,"Pocahontas County",19151,356,42,398,0.8944723618
No,Iowa,19,"Polk County",19153,9504,1536,11040,0.8608695652
No,Iowa,19,"Pottawattamie County",19155,2571,444,3015,0.8527363184
No,Iowa,19,"Poweshiek County",19157,767,90,857,0.8949824971
No,Iowa,19,"Ringgold County",19159,218,24,242,0.9008264463
No,Iowa,19,"Sac County",19161,460,77,537,0.8566108007
No,Iowa,19,"Scott County",19163,4015,651,4666,0.8604800686
No,Iowa,19,"Shelby County",19165,589,88,677,0.870014771
No,Iowa,19,"Sioux County",19167,1232,134,1366,0.9019033675
No,Iowa,19,"Story County",19169,2126,290,2416,0.8799668874
No,Iowa,19,"Tama County",19171,669,102,771,0.8677042802
No,Iowa,19,"Taylor County",19173,270,47,317,0.8517350158
No,Iowa,19,"Union County",19175,457,95,552,0.8278985507
No,Iowa,19,"Van Buren County",19177,265,61,326,0.8128834356
No,Iowa,19,"Wapello County",19179,1129,222,1351,0.8356772761
No,Iowa,19,"Warren County",19181,1394,212,1606,0.8679950187
No,Iowa,19,"Washington County",19183,815,125,940,0.8670212766
No,Iowa,19,"Wayne County",19185,244,42,286,0.8531468531
No,Iowa,19,"Webster County",19187,1312,207,1519,0.8637261356
No,Iowa,19,"Winnebago County",19189,493,55,548,0.8996350365
No,Iowa,19,"Winneshiek County",19191,813,109,922,0.8817787419
No,Iowa,19,"Woodbury County",19193,2297,394,2691,0.8535860275
No,Iowa,19,"Worth County",19195,319,61,380,0.8394736842
No,Iowa,19,"Wright County",19197,552,79,631,0.8748019017
No,Iowa,19,,19999,.,.,.,0.9
No,Kansas,20,"Allen County",20001,412,93,505,0.8158415842
No,Kansas,20,"Anderson County",20003,284,61,345,0.8231884058
No,Kansas,20,"Atchison County",20005,483,80,563,0.8579040853
No,Kansas,20,"Barber County",20007,178,48,226,0.7876106195
No,Kansas,20,"Barton County",20009,873,178,1051,0.8306374881
No,Kansas,20,"Bourbon County",20011,426,89,515,0.827184466
No,Kansas,20,"Brown County",20013,344,58,402,0.855721393
No,Kansas,20,"Butler County",20015,1591,284,1875,0.8485333333
No,Kansas,20,"Chase County",20017,98,12,110,0.8909090909
No,Kansas,20,"Chautauqua County",20019,126,28,154,0.8181818182
No,Kansas,20,"Cherokee County",20021,554,136,690,0.8028985507
No,Kansas,20,"Cheyenne County",20023,122,37,159,0.7672955975
No,Kansas,20,"Clark County",20025,84,20,104,0.8076923077
No,Kansas,20,"Clay County",20027,289,47,336,0.8601190476
No,Kansas,20,"Cloud County",20029,368,71,439,0.8382687927
No,Kansas,20,"Coffey County",20031,317,71,388,0.8170103093
No,Kansas,20,"Comanche County",20033,80,13,93,0.8602150538
No,Kansas,20,"Cowley County",20035,944,254,1198,0.7879799666
No,Kansas,20,"Crawford County",20037,1059,232,1291,0.8202943455
No,Kansas,20,"Decatur County",20039,128,26,154,0.8311688312
No,Kansas,20,"Dickinson County",20041,617,105,722,0.8545706371
No,Kansas,20,"Doniphan County",20043,227,52,279,0.8136200717
No,Kansas,20,"Douglas County",20045,2038,350,2388,0.8534338358
No,Kansas,20,"Edwards County",20047,113,43,156,0.7243589744
No,Kansas,20,"Elk County",20049,101,20,121,0.8347107438
No,Kansas,20,"Ellis County",20051,875,129,1004,0.8715139442
No,Kansas,20,"Ellsworth County",20053,226,64,290,0.7793103448
No,Kansas,20,"Finney County",20055,503,119,622,0.808681672
No,Kansas,20,"Ford County",20057,610,104,714,0.8543417367
No,Kansas,20,"Franklin County",20059,624,134,758,0.8232189974
No,Kansas,20,"Geary County",20061,243,49,292,0.8321917808
No,Kansas,20,"Gove County",20063,115,41,156,0.7371794872
No,Kansas,20,"Graham County",20065,99,26,125,0.792
No,Kansas,20,"Grant County",20067,166,32,198,0.8383838384
No,Kansas,20,"Gray County",20069,184,34,218,0.8440366972
No,Kansas,20,"Greeley County",20071,.,.,.,0.9333333333
No,Kansas,20,"Greenwood County",20073,239,66,305,0.7836065574
No,Kansas,20,"Hamilton County",20075,.,.,.,0.8636363636
No,Kansas,20,"Harper County",20077,227,47,274,0.8284671533
No,Kansas,20,"Harvey County",20079,1129,233,1362,0.828928047
No,Kansas,20,"Haskell County",20081,90,14,104,0.8653846154
No,Kansas,20,"Hodgeman County",20083,85,20,105,0.8095238095
No,Kansas,20,"Jackson County",20085,387,86,473,0.8181818182
No,Kansas,20,"Jefferson County",20087,552,94,646,0.8544891641
No,Kansas,20,"Jewell County",20089,150,30,180,0.8333333333
No,Kansas,20,"Johnson County",20091,10188,1913,12101,0.8419138914
No,Kansas,20,"Kearny County",20093,92,14,106,0.8679245283
No,Kansas,20,"Kingman County",20095,297,54,351,0.8461538462
No,Kansas,20,"Kiowa County",20097,71,16,87,0.816091954
No,Kansas,20,"Labette County",20099,480,115,595,0.8067226891
No,Kansas,20,"Lane County",20101,76,18,94,0.8085106383
No,Kansas,20,"Leavenworth County",20103,1244,246,1490,0.8348993289
No,Kansas,20,"Lincoln County",20105,174,32,206,0.8446601942
No,Kansas,20,"Linn County",20107,282,65,347,0.8126801153
No,Kansas,20,"Logan County",20109,129,25,154,0.8376623377
No,Kansas,20,"Lyon County",20111,922,158,1080,0.8537037037
No,Kansas,20,"McPherson County",20113,980,190,1170,0.8376068376
No,Kansas,20,"Marion County",20115,526,95,621,0.847020934
No,Kansas,20,"Marshall County",20117,402,79,481,0.8357588358
No,Kansas,20,"Meade County",20119,110,20,130,0.8461538462
No,Kansas,20,"Miami County",20121,864,151,1015,0.8512315271
No,Kansas,20,"Mitchell County",20123,346,56,402,0.8606965174
No,Kansas,20,"Montgomery County",20125,952,206,1158,0.8221070812
No,Kansas,20,"Morris County",20127,212,38,250,0.848
No,Kansas,20,"Morton County",20129,109,25,134,0.8134328358
No,Kansas,20,"Nemaha County",20131,381,47,428,0.8901869159
No,Kansas,20,"Neosho County",20133,492,102,594,0.8282828283
No,Kansas,20,"Ness County",20135,145,30,175,0.8285714286
No,Kansas,20,"Norton County",20137,184,44,228,0.8070175439
No,Kansas,20,"Osage County",20139,541,85,626,0.8642172524
No,Kansas,20,"Osborne County",20141,192,39,231,0.8311688312
No,Kansas,20,"Ottawa County",20143,227,35,262,0.8664122137
No,Kansas,20,"Pawnee County",20145,203,52,255,0.7960784314
No,Kansas,20,"Phillips County",20147,265,54,319,0.8307210031
No,Kansas,20,"Pottawatomie County",20149,533,110,643,0.8289269051
No,Kansas,20,"Pratt County",20151,307,72,379,0.8100263852
No,Kansas,20,"Rawlins County",20153,103,31,134,0.7686567164
No,Kansas,20,"Reno County",20155,1990,379,2369,0.8400168848
No,Kansas,20,"Republic County",20157,290,24,314,0.923566879
No,Kansas,20,"Rice County",20159,311,71,382,0.8141361257
No,Kansas,20,"Riley County",20161,910,137,1047,0.8691499522
No,Kansas,20,"Rooks County",20163,203,37,240,0.8458333333
No,Kansas,20,"Rush County",20165,164,29,193,0.8497409326
No,Kansas,20,"Russell County",20167,303,56,359,0.8440111421
No,Kansas,20,"Saline County",20169,1769,290,2059,0.8591549296
No,Kansas,20,"Scott County",20171,174,26,200,0.87
No,Kansas,20,"Sedgwick County",20173,9716,2161,11877,0.8180516966
No,Kansas,20,"Seward County",20175,250,72,322,0.7763975155
No,Kansas,20,"Shawnee County",20177,4981,884,5865,0.8492753623
No,Kansas,20,"Sheridan County",20179,125,22,147,0.8503401361
No,Kansas,20,"Sherman County",20181,154,51,205,0.7512195122
No,Kansas,20,"Smith County",20183,205,37,242,0.847107438
No,Kansas,20,"Stafford County",20185,146,30,176,0.8295454545
No,Kansas,20,"Stanton County",20187,49,11,60,0.8166666667
No,Kansas,20,"Stevens County",20189,147,24,171,0.8596491228
No,Kansas,20,"Sumner County",20191,656,157,813,0.8068880689
No,Kansas,20,"Thomas County",20193,264,51,315,0.8380952381
No,Kansas,20,"Trego County",20195,153,25,178,0.8595505618
No,Kansas,20,"Wabaunsee County",20197,235,42,277,0.8483754513
No,Kansas,20,"Wallace County",20199,73,13,86,0.8488372093
No,Kansas,20,"Washington County",20201,268,35,303,0.8844884488
No,Kansas,20,"Wichita County",20203,65,16,81,0.8024691358
No,Kansas,20,"Wilson County",20205,307,73,380,0.8078947368
No,Kansas,20,"Woodson County",20207,127,21,148,0.8581081081
No,Kansas,20,"Wyandotte County",20209,1922,477,2399,0.801167153
No,Kansas,20,,20999,.,.,.,0.7307692308
No,Kentucky,21,"Adair County",21001,478,99,577,0.8284228769
No,Kentucky,21,"Allen County",21003,546,147,693,0.7878787879
No,Kentucky,21,"Anderson County",21005,497,109,606,0.8201320132
No,Kentucky,21,"Ballard County",21007,318,59,377,0.8435013263
No,Kentucky,21,"Barren County",21009,1333,322,1655,0.8054380665
No,Kentucky,21,"Bath County",21011,243,50,293,0.8293515358
No,Kentucky,21,"Bell County",21013,540,161,701,0.7703281027
No,Kentucky,21,"Boone County",21015,2086,420,2506,0.8324022346
No,Kentucky,21,"Bourbon County",21017,531,108,639,0.8309859155
No,Kentucky,21,"Boyd County",21019,1532,366,1898,0.8071654373
No,Kentucky,21,"Boyle County",21021,740,168,908,0.8149779736
No,Kentucky,21,"Bracken County",21023,194,35,229,0.8471615721
No,Kentucky,21,"Breathitt County",21025,203,49,252,0.8055555556
No,Kentucky,21,"Breckinridge County",21027,542,116,658,0.8237082067
No,Kentucky,21,"Bullitt County",21029,1990,405,2395,0.8308977035
No,Kentucky,21,"Butler County",21031,300,100,400,0.75
No,Kentucky,21,"Caldwell County",21033,392,79,471,0.8322717622
No,Kentucky,21,"Calloway County",21035,1086,235,1321,0.8221044663
No,Kentucky,21,"Campbell County",21037,1699,365,2064,0.8231589147
No,Kentucky,21,"Carlisle County",21039,179,44,223,0.802690583
No,Kentucky,21,"Carroll County",21041,207,69,276,0.75
No,Kentucky,21,"Carter County",21043,698,188,886,0.7878103837
No,Kentucky,21,"Casey County",21045,372,69,441,0.843537415
No,Kentucky,21,"Christian County",21047,1074,325,1399,0.767691208
No,Kentucky,21,"Clark County",21049,759,182,941,0.8065887354
No,Kentucky,21,"Clay County",21051,237,74,311,0.7620578778
No,Kentucky,21,"Clinton County",21053,197,64,261,0.754789272
No,Kentucky,21,"Crittenden County",21055,307,54,361,0.8504155125
No,Kentucky,21,"Cumberland County",21057,173,45,218,0.7935779817
No,Kentucky,21,"Daviess County",21059,2749,614,3363,0.8174249182
No,Kentucky,21,"Edmonson County",21061,353,81,434,0.8133640553
No,Kentucky,21,"Elliott County",21063,109,24,133,0.8195488722
No,Kentucky,21,"Estill County",21065,300,87,387,0.7751937984
No,Kentucky,21,"Fayette County",21067,4656,1109,5765,0.8076322637
No,Kentucky,21,"Fleming County",21069,340,86,426,0.7981220657
No,Kentucky,21,"Floyd County",21071,783,217,1000,0.783
No,Kentucky,21,"Franklin County",21073,1246,268,1514,0.822985469
No,Kentucky,21,"Fulton County",21075,198,48,246,0.8048780488
No,Kentucky,21,"Gallatin County",21077,139,37,176,0.7897727273
No,Kentucky,21,"Garrard County",21079,452,99,551,0.8203266788
No,Kentucky,21,"Grant County",21081,491,111,602,0.8156146179
No,Kentucky,21,"Graves County",21083,1151,241,1392,0.8268678161
No,Kentucky,21,"Grayson County",21085,689,163,852,0.808685446
No,Kentucky,21,"Green County",21087,346,80,426,0.8122065728
No,Kentucky,21,"Greenup County",21089,1243,353,1596,0.7788220551
No,Kentucky,21,"Hancock County",21091,248,54,302,0.821192053
No,Kentucky,21,"Hardin County",21093,1786,387,2173,0.8219052002
No,Kentucky,21,"Harlan County",21095,534,174,708,0.7542372881
No,Kentucky,21,"Harrison County",21097,470,120,590,0.7966101695
No,Kentucky,21,"Hart County",21099,524,132,656,0.7987804878
No,Kentucky,21,"Henderson County",21101,1236,271,1507,0.8201725282
No,Kentucky,21,"Henry County",21103,383,66,449,0.8530066815
No,Kentucky,21,"Hickman County",21105,195,40,235,0.829787234
No,Kentucky,21,"Hopkins County",21107,1188,273,1461,0.8131416838
No,Kentucky,21,"Jackson County",21109,199,67,266,0.7481203008
No,Kentucky,21,"Jefferson County",21111,16564,3842,20406,0.8117220425
No,Kentucky,21,"Jessamine County",21113,939,184,1123,0.8361531612
No,Kentucky,21,"Johnson County",21115,517,154,671,0.7704918033
No,Kentucky,21,"Kenton County",21117,2861,606,3467,0.8252091145
No,Kentucky,21,"Knott County",21119,305,65,370,0.8243243243
No,Kentucky,21,"Knox County",21121,497,158,655,0.758778626
No,Kentucky,21,"Larue County",21123,431,105,536,0.8041044776
No,Kentucky,21,"Laurel County",21125,1242,320,1562,0.795134443
No,Kentucky,21,"Lawrence County",21127,416,118,534,0.7790262172
No,Kentucky,21,"Lee County",21129,115,33,148,0.777027027
No,Kentucky,21,"Leslie County",21131,189,69,258,0.7325581395
No,Kentucky,21,"Letcher County",21133,484,148,632,0.7658227848
No,Kentucky,21,"Lewis County",21135,286,65,351,0.8148148148
No,Kentucky,21,"Lincoln County",21137,614,140,754,0.8143236074
No,Kentucky,21,"Livingston County",21139,344,60,404,0.8514851485
No,Kentucky,21,"Logan County",21141,864,200,1064,0.8120300752
No,Kentucky,21,"Lyon County",21143,302,63,365,0.8273972603
No,Kentucky,21,"McCracken County",21145,2062,480,2542,0.8111723053
No,Kentucky,21,"McCreary County",21147,267,62,329,0.811550152
No,Kentucky,21,"McLean County",21149,246,47,293,0.8395904437
No,Kentucky,21,"Madison County",21151,1555,410,1965,0.7913486005
No,Kentucky,21,"Magoffin County",21153,222,74,296,0.75
No,Kentucky,21,"Marion County",21155,475,113,588,0.8078231293
No,Kentucky,21,"Marshall County",21157,1219,258,1477,0.8253215978
No,Kentucky,21,"Martin County",21159,245,69,314,0.7802547771
No,Kentucky,21,"Mason County",21161,424,77,501,0.8463073852
No,Kentucky,21,"Meade County",21163,518,140,658,0.7872340426
No,Kentucky,21,"Menifee County",21165,129,36,165,0.7818181818
No,Kentucky,21,"Mercer County",21167,593,139,732,0.8101092896
No,Kentucky,21,"Metcalfe County",21169,251,50,301,0.8338870432
No,Kentucky,21,"Monroe County",21171,261,73,334,0.7814371257
No,Kentucky,21,"Montgomery County",21173,530,123,653,0.8116385911
No,Kentucky,21,"Morgan County",21175,260,57,317,0.8201892744
No,Kentucky,21,"Muhlenberg County",21177,941,227,1168,0.8056506849
No,Kentucky,21,"Nelson County",21179,1341,296,1637,0.8191814294
No,Kentucky,21,"Nicholas County",21181,232,38,270,0.8592592593
No,Kentucky,21,"Ohio County",21183,566,151,717,0.7894002789
No,Kentucky,21,"Oldham County",21185,1247,240,1487,0.8386012105
No,Kentucky,21,"Owen County",21187,266,60,326,0.8159509202
No,Kentucky,21,"Owsley County",21189,50,18,68,0.7352941176
No,Kentucky,21,"Pendleton County",21191,336,64,400,0.84
No,Kentucky,21,"Perry County",21193,587,184,771,0.7613488975
No,Kentucky,21,"Pike County",21195,1465,416,1881,0.778841042
No,Kentucky,21,"Powell County",21197,231,71,302,0.7649006623
No,Kentucky,21,"Pulaski County",21199,1734,362,2096,0.8272900763
No,Kentucky,21,"Robertson County",21201,51,13,64,0.796875
No,Kentucky,21,"Rockcastle County",21203,340,92,432,0.787037037
No,Kentucky,21,"Rowan County",21205,457,133,590,0.7745762712
No,Kentucky,21,"Russell County",21207,407,124,531,0.7664783427
No,Kentucky,21,"Scott County",21209,893,220,1113,0.8023360288
No,Kentucky,21,"Shelby County",21211,1071,252,1323,0.8095238095
No,Kentucky,21,"Simpson County",21213,534,138,672,0.7946428571
No,Kentucky,21,"Spencer County",21215,377,93,470,0.8021276596
No,Kentucky,21,"Taylor County",21217,784,180,964,0.8132780083
No,Kentucky,21,"Todd County",21219,290,75,365,0.7945205479
No,Kentucky,21,"Trigg County",21221,465,95,560,0.8303571429
No,Kentucky,21,"Trimble County",21223,214,43,257,0.8326848249
No,Kentucky,21,"Union County",21225,452,105,557,0.8114901257
No,Kentucky,21,"Warren County",21227,2525,593,3118,0.8098139833
No,Kentucky,21,"Washington County",21229,344,58,402,0.855721393
No,Kentucky,21,"Wayne County",21231,423,103,526,0.8041825095
No,Kentucky,21,"Webster County",21233,342,77,419,0.8162291169
No,Kentucky,21,"Whitley County",21235,699,233,932,0.75
No,Kentucky,21,"Wolfe County",21237,117,27,144,0.8125
No,Kentucky,21,"Woodford County",21239,614,130,744,0.8252688172
No,Kentucky,21,,21999,.,.,.,0.8421052632
No,Louisiana,22,"Acadia Parish",22001,1265,322,1587,0.7971014493
No,Louisiana,22,"Allen Parish",22003,435,124,559,0.7781753131
No,Louisiana,22,"Ascension Parish",22005,1216,292,1508,0.8063660477
No,Louisiana,22,"Assumption Parish",22007,581,131,712,0.816011236
No,Louisiana,22,"Avoyelles Parish",22009,809,185,994,0.8138832998
No,Louisiana,22,"Beauregard Parish",22011,694,199,893,0.7771556551
No,Louisiana,22,"Bienville Parish",22013,295,92,387,0.7622739018
No,Louisiana,22,"Bossier Parish",22015,1595,379,1974,0.8080040527
No,Louisiana,22,"Caddo Parish",22017,3893,1116,5009,0.7772010381
No,Louisiana,22,"Calcasieu Parish",22019,3626,1075,4701,0.7713252499
No,Louisiana,22,"Caldwell Parish",22021,216,68,284,0.7605633803
No,Louisiana,22,"Cameron Parish",22023,151,45,196,0.7704081633
No,Louisiana,22,"Catahoula Parish",22025,220,65,285,0.7719298246
No,Louisiana,22,"Claiborne Parish",22027,361,100,461,0.7830802603
No,Louisiana,22,"Concordia Parish",22029,436,109,545,0.8
No,Louisiana,22,"De Soto Parish",22031,561,194,755,0.7430463576
No,Louisiana,22,"East Baton Rouge Parish",22033,5711,1422,7133,0.8006448899
No,Louisiana,22,"East Carroll Parish",22035,112,30,142,0.7887323944
No,Louisiana,22,"East Feliciana Parish",22037,412,143,555,0.7423423423
No,Louisiana,22,"Evangeline Parish",22039,771,212,983,0.7843336724
No,Louisiana,22,"Franklin Parish",22041,365,125,490,0.7448979592
No,Louisiana,22,"Grant Parish",22043,386,121,507,0.7613412229
No,Louisiana,22,"Iberia Parish",22045,1583,347,1930,0.8202072539
No,Louisiana,22,"Iberville Parish",22047,444,114,558,0.7956989247
No,Louisiana,22,"Jackson Parish",22049,410,127,537,0.7635009311
No,Louisiana,22,"Jefferson Parish",22051,4304,979,5283,0.8146886239
No,Louisiana,22,"Jefferson Davis Parish",22053,725,176,901,0.8046614872
No,Louisiana,22,"Lafayette Parish",22055,4191,919,5110,0.8201565558
No,Louisiana,22,"Lafourche Parish",22057,2928,534,3462,0.8457538995
No,Louisiana,22,"La Salle Parish",22059,373,120,493,0.7565922921
No,Louisiana,22,"Lincoln Parish",22061,787,231,1018,0.7730844794
No,Louisiana,22,"Livingston Parish",22063,1655,350,2005,0.825436409
No,Louisiana,22,"Madison Parish",22065,149,42,191,0.780104712
No,Louisiana,22,"Morehouse Parish",22067,546,141,687,0.7947598253
No,Louisiana,22,"Natchitoches Parish",22069,749,216,965,0.7761658031
No,Louisiana,22,"Orleans Parish",22071,2459,682,3141,0.7828716969
No,Louisiana,22,"Ouachita Parish",22073,3032,817,3849,0.7877370746
No,Louisiana,22,"Plaquemines Parish",22075,164,44,208,0.7884615385
No,Louisiana,22,"Pointe Coupee Parish",22077,423,109,532,0.795112782
No,Louisiana,22,"Rapides Parish",22079,2579,683,3262,0.790619252
No,Louisiana,22,"Red River Parish",22081,183,55,238,0.768907563
No,Louisiana,22,"Richland Parish",22083,416,128,544,0.7647058824
No,Louisiana,22,"Sabine Parish",22085,669,186,855,0.7824561404
No,Louisiana,22,"St. Bernard Parish",22087,325,102,427,0.7611241218
No,Louisiana,22,"St. Charles Parish",22089,552,157,709,0.778561354
No,Louisiana,22,"St. Helena Parish",22091,213,56,269,0.7918215613
No,Louisiana,22,"St. James Parish",22093,474,108,582,0.8144329897
No,Louisiana,22,"St. John the Baptist Parish",22095,520,96,616,0.8441558442
No,Louisiana,22,"St. Landry Parish",22097,1897,483,2380,0.7970588235
No,Louisiana,22,"St. Martin Parish",22099,959,234,1193,0.8038558256
No,Louisiana,22,"St. Mary Parish",22101,1153,315,1468,0.7854223433
No,Louisiana,22,"St. Tammany Parish",22103,3771,856,4627,0.8149989194
No,Louisiana,22,"Tangipahoa Parish",22105,1977,429,2406,0.8216957606
No,Louisiana,22,"Tensas Parish",22107,91,37,128,0.7109375
No,Louisiana,22,"Terrebonne Parish",22109,2763,548,3311,0.8344910903
No,Louisiana,22,"Union Parish",22111,619,178,797,0.7766624843
No,Louisiana,22,"Vermilion Parish",22113,1221,270,1491,0.8189134809
No,Louisiana,22,"Vernon Parish",22115,579,174,753,0.7689243028
No,Louisiana,22,"Washington Parish",22117,972,291,1263,0.7695961995
No,Louisiana,22,"Webster Parish",22119,1070,253,1323,0.8087679516
No,Louisiana,22,"West Baton Rouge Parish",22121,331,82,413,0.8014527845
No,Louisiana,22,"West Carroll Parish",22123,313,81,394,0.7944162437
No,Louisiana,22,"West Feliciana Parish",22125,194,59,253,0.766798419
No,Louisiana,22,"Winn Parish",22127,381,99,480,0.79375
No,Louisiana,22,,22999,.,.,.,0.8684210526
No,Maine,23,"Androscoggin County",23001,1560,225,1785,0.8739495798
No,Maine,23,"Aroostook County",23003,1812,254,2066,0.8770571152
No,Maine,23,"Cumberland County",23005,5182,789,5971,0.8678613298
No,Maine,23,"Franklin County",23007,567,100,667,0.8500749625
No,Maine,23,"Hancock County",23009,1386,232,1618,0.8566131026
No,Maine,23,"Kennebec County",23011,1852,294,2146,0.863000932
No,Maine,23,"Knox County",23013,977,181,1158,0.8436960276
No,Maine,23,"Lincoln County",23015,829,154,983,0.8433367243
No,Maine,23,"Oxford County",23017,1105,160,1265,0.8735177866
No,Maine,23,"Penobscot County",23019,2804,459,3263,0.8593319032
No,Maine,23,"Piscataquis County",23021,364,64,428,0.8504672897
No,Maine,23,"Sagadahoc County",23023,726,110,836,0.8684210526
No,Maine,23,"Somerset County",23025,1020,188,1208,0.8443708609
No,Maine,23,"Waldo County",23027,758,144,902,0.8403547672
No,Maine,23,"Washington County",23029,899,152,1051,0.8553758325
No,Maine,23,"York County",23031,4720,734,5454,0.8654198753
No,Maine,23,,23999,.,0,.,1
No,Maryland,24,"Allegany County",24001,2700,554,3254,0.8297480025
No,Maryland,24,"Anne Arundel County",24003,10971,1988,12959,0.8465931013
No,Maryland,24,"Baltimore County",24005,20518,4135,24653,0.8322719345
No,Maryland,24,"Calvert County",24009,1611,308,1919,0.8394997394
No,Maryland,24,"Caroline County",24011,971,217,1188,0.8173400673
No,Maryland,24,"Carroll County",24013,4969,828,5797,0.8571675004
No,Maryland,24,"Cecil County",24015,2643,553,3196,0.826971214
No,Maryland,24,"Charles County",24017,1716,432,2148,0.7988826816
No,Maryland,24,"Dorchester County",24019,1231,240,1471,0.8368456832
No,Maryland,24,"Frederick County",24021,5362,898,6260,0.8565495208
No,Maryland,24,"Garrett County",24023,1197,213,1410,0.8489361702
No,Maryland,24,"Harford County",24025,6248,1151,7399,0.8444384376
No,Maryland,24,"Howard County",24027,4405,778,5183,0.8498938839
No,Maryland,24,"Kent County",24029,844,146,990,0.8525252525
No,Maryland,24,"Montgomery County",24031,12666,2530,15196,0.8335088181
No,Maryland,24,"Prince George",24033,7304,2028,9332,0.7826832405
No,Maryland,24,"Queen Anne",24035,1638,234,1872,0.875
No,Maryland,24,"St. Mary",24037,1322,266,1588,0.8324937028
No,Maryland,24,"Somerset County",24039,688,161,849,0.8103651355
No,Maryland,24,"Talbot County",24041,1814,316,2130,0.8516431925
No,Maryland,24,"Washington County",24043,3711,660,4371,0.8490048044
No,Maryland,24,"Wicomico County",24045,2646,496,3142,0.8421387651
No,Maryland,24,"Worcester County",24047,2215,398,2613,0.8476846537
No,Maryland,24,"Baltimore city",24510,7802,2245,10047,0.776550214
No,Maryland,24,,24999,47,11,58,0.8103448276
No,Massachusetts,25,"Barnstable County",25001,10683,1701,12384,0.8626453488
No,Massachusetts,25,"Berkshire County",25003,4442,741,5183,0.8570326066
No,Massachusetts,25,"Bristol County",25005,14928,2339,17267,0.8645392946
No,Massachusetts,25,"Dukes County",25007,596,115,711,0.8382559775
No,Massachusetts,25,"Essex County",25009,18430,2654,21084,0.8741225574
No,Massachusetts,25,"Franklin County",25011,1673,277,1950,0.8579487179
No,Massachusetts,25,"Hampden County",25013,8973,1420,10393,0.8633695757
No,Massachusetts,25,"Hampshire County",25015,3498,538,4036,0.8666997027
No,Massachusetts,25,"Middlesex County",25017,29627,4692,34319,0.8632827297
No,Massachusetts,25,"Nantucket County",25019,326,63,389,0.8380462725
No,Massachusetts,25,"Norfolk County",25021,16295,2565,18860,0.8639978791
No,Massachusetts,25,"Plymouth County",25023,15330,2440,17770,0.8626899268
No,Massachusetts,25,"Suffolk County",25025,7594,1428,9022,0.8417202394
No,Massachusetts,25,"Worcester County",25027,15073,2417,17490,0.8618067467
No,Massachusetts,25,,25999,.,.,.,0.8947368421
No,Michigan,26,"Alcona County",26001,590,105,695,0.8489208633
No,Michigan,26,"Alger County",26003,247,54,301,0.8205980066
No,Michigan,26,"Allegan County",26005,1839,360,2199,0.8362892224
No,Michigan,26,"Alpena County",26007,1167,188,1355,0.8612546125
No,Michigan,26,"Antrim County",26009,806,167,973,0.8283658787
No,Michigan,26,"Arenac County",26011,630,95,725,0.8689655172
No,Michigan,26,"Baraga County",26013,259,38,297,0.8720538721
No,Michigan,26,"Barry County",26015,1270,247,1517,0.8371786421
No,Michigan,26,"Bay County",26017,3633,637,4270,0.8508196721
No,Michigan,26,"Benzie County",26019,508,89,597,0.850921273
No,Michigan,26,"Berrien County",26021,3893,810,4703,0.8277695088
No,Michigan,26,"Branch County",26023,1352,224,1576,0.8578680203
No,Michigan,26,"Calhoun County",26025,3070,589,3659,0.8390270566
No,Michigan,26,"Cass County",26027,1331,294,1625,0.8190769231
No,Michigan,26,"Charlevoix County",26029,838,154,992,0.8447580645
No,Michigan,26,"Cheboygan County",26031,902,165,1067,0.8453608247
No,Michigan,26,"Chippewa County",26033,845,130,975,0.8666666667
No,Michigan,26,"Clare County",26035,1095,214,1309,0.8365164248
No,Michigan,26,"Clinton County",26037,1750,312,2062,0.8486905917
No,Michigan,26,"Crawford County",26039,438,87,525,0.8342857143
No,Michigan,26,"Delta County",26041,1222,201,1423,0.8587491216
No,Michigan,26,"Dickinson County",26043,752,105,857,0.8774795799
No,Michigan,26,"Eaton County",26045,2664,535,3199,0.8327602376
No,Michigan,26,"Emmet County",26047,863,173,1036,0.833011583
No,Michigan,26,"Genesee County",26049,10866,2530,13396,0.811137653
No,Michigan,26,"Gladwin County",26051,1153,201,1354,0.8515509601
No,Michigan,26,"Gogebic County",26053,540,71,611,0.883797054
No,Michigan,26,"Grand Traverse County",26055,2013,321,2334,0.8624678663
No,Michigan,26,"Gratiot County",26057,1175,209,1384,0.8489884393
No,Michigan,26,"Hillsdale County",26059,1338,254,1592,0.8404522613
No,Michigan,26,"Houghton County",26061,735,132,867,0.8477508651
No,Michigan,26,"Huron County",26063,1554,314,1868,0.8319057816
No,Michigan,26,"Ingham County",26065,4277,944,5221,0.8191917257
No,Michigan,26,"Ionia County",26067,1309,221,1530,0.8555555556
No,Michigan,26,"Iosco County",26069,1096,207,1303,0.8411358404
No,Michigan,26,"Iron County",26071,460,82,542,0.8487084871
No,Michigan,26,"Isabella County",26073,1208,247,1455,0.8302405498
No,Michigan,26,"Jackson County",26075,4466,834,5300,0.8426415094
No,Michigan,26,"Kalamazoo County",26077,4796,957,5753,0.8336520076
No,Michigan,26,"Kalkaska County",26079,476,95,571,0.8336252189
No,Michigan,26,"Kent County",26081,7798,1395,9193,0.8482541064
No,Michigan,26,"Keweenaw County",26083,81,13,94,0.8617021277
No,Michigan,26,"Lake County",26085,377,82,459,0.8213507625
No,Michigan,26,"Lapeer County",26087,2719,523,3242,0.8386798273
No,Michigan,26,"Leelanau County",26089,707,131,838,0.8436754177
No,Michigan,26,"Lenawee County",26091,2905,505,3410,0.8519061584
No,Michigan,26,"Livingston County",26093,4128,735,4863,0.8488587292
No,Michigan,26,"Luce County",26095,200,39,239,0.8368200837
No,Michigan,26,"Mackinac County",26097,426,79,505,0.8435643564
No,Michigan,26,"Macomb County",26099,22094,4297,26391,0.8371793414
No,Michigan,26,"Manistee County",26101,757,157,914,0.8282275711
No,Michigan,26,"Marquette County",26103,1341,243,1584,0.8465909091
No,Michigan,26,"Mason County",26105,999,164,1163,0.8589853826
No,Michigan,26,"Mecosta County",26107,1001,196,1197,0.8362573099
No,Michigan,26,"Menominee County",26109,782,99,881,0.8876276958
No,Michigan,26,"Midland County",26111,2851,413,3264,0.8734681373
No,Michigan,26,"Missaukee County",26113,428,65,493,0.8681541582
No,Michigan,26,"Monroe County",26115,4532,938,5470,0.8285191956
No,Michigan,26,"Montcalm County",26117,1290,257,1547,0.8338720103
No,Michigan,26,"Montmorency County",26119,464,94,558,0.8315412186
No,Michigan,26,"Muskegon County",26121,3005,650,3655,0.8221614227
No,Michigan,26,"Newaygo County",26123,954,157,1111,0.8586858686
No,Michigan,26,"Oakland County",26125,25968,5626,31594,0.8219282142
No,Michigan,26,"Oceana County",26127,618,107,725,0.8524137931
No,Michigan,26,"Ogemaw County",26129,870,177,1047,0.8309455587
No,Michigan,26,"Ontonagon County",26131,288,55,343,0.8396501458
No,Michigan,26,"Osceola County",26133,634,126,760,0.8342105263
No,Michigan,26,"Oscoda County",26135,318,70,388,0.8195876289
No,Michigan,26,"Otsego County",26137,780,137,917,0.8505997819
No,Michigan,26,"Ottawa County",26139,3680,601,4281,0.8596122401
No,Michigan,26,"Presque Isle County",26141,677,105,782,0.8657289003
No,Michigan,26,"Roscommon County",26143,1290,232,1522,0.8475689882
No,Michigan,26,"Saginaw County",26145,5570,1130,6700,0.8313432836
No,Michigan,26,"St. Clair County",26147,4549,859,5408,0.8411612426
No,Michigan,26,"St. Joseph County",26149,1611,287,1898,0.8487881981
No,Michigan,26,"Sanilac County",26151,1331,277,1608,0.8277363184
No,Michigan,26,"Schoolcraft County",26153,339,70,409,0.8288508557
No,Michigan,26,"Shiawassee County",26155,1869,368,2237,0.8354939651
No,Michigan,26,"Tuscola County",26157,2024,398,2422,0.8356729975
No,Michigan,26,"Van Buren County",26159,1757,307,2064,0.8512596899
No,Michigan,26,"Washtenaw County",26161,4300,877,5177,0.8305968708
No,Michigan,26,"Wayne County",26163,30527,7865,38392,0.7951396124
No,Michigan,26,"Wexford County",26165,856,129,985,0.869035533
No,Michigan,26,,26999,77,16,93,0.8279569892
No,Minnesota,27,"Aitkin County",27001,335,50,385,0.8701298701
No,Minnesota,27,"Anoka County",27003,4708,705,5413,0.86975799
No,Minnesota,27,"Becker County",27005,870,118,988,0.8805668016
No,Minnesota,27,"Beltrami County",27007,953,135,1088,0.8759191176
No,Minnesota,27,"Benton County",27009,608,70,678,0.8967551622
No,Minnesota,27,"Big Stone County",27011,176,19,195,0.9025641026
No,Minnesota,27,"Blue Earth County",27013,1356,178,1534,0.8839634941
No,Minnesota,27,"Brown County",27015,1025,133,1158,0.8851468048
No,Minnesota,27,"Carlton County",27017,599,78,677,0.8847858198
No,Minnesota,27,"Carver County",27019,1142,159,1301,0.8777863182
No,Minnesota,27,"Cass County",27021,796,127,923,0.8624052004
No,Minnesota,27,"Chippewa County",27023,400,44,444,0.9009009009
No,Minnesota,27,"Chisago County",27025,907,136,1043,0.8696069032
No,Minnesota,27,"Clay County",27027,1113,140,1253,0.8882681564
No,Minnesota,27,"Clearwater County",27029,203,31,234,0.8675213675
No,Minnesota,27,"Cook County",27031,100,21,121,0.826446281
No,Minnesota,27,"Cottonwood County",27033,389,57,446,0.8721973094
No,Minnesota,27,"Crow Wing County",27035,1680,266,1946,0.8633093525
No,Minnesota,27,"Dakota County",27037,5972,875,6847,0.8722068059
No,Minnesota,27,"Dodge County",27039,347,52,399,0.8696741855
No,Minnesota,27,"Douglas County",27041,1103,155,1258,0.8767885533
No,Minnesota,27,"Faribault County",27043,467,79,546,0.8553113553
No,Minnesota,27,"Fillmore County",27045,569,73,642,0.8862928349
No,Minnesota,27,"Freeborn County",27047,817,113,930,0.8784946237
No,Minnesota,27,"Goodhue County",27049,745,109,854,0.8723653396
No,Minnesota,27,"Grant County",27051,208,28,236,0.8813559322
No,Minnesota,27,"Hennepin County",27053,14974,2380,17354,0.8628558257
No,Minnesota,27,"Houston County",27055,585,67,652,0.8972392638
No,Minnesota,27,"Hubbard County",27057,728,121,849,0.8574793875
No,Minnesota,27,"Isanti County",27059,719,118,837,0.8590203106
No,Minnesota,27,"Itasca County",27061,991,139,1130,0.8769911504
No,Minnesota,27,"Jackson County",27063,424,39,463,0.9157667387
No,Minnesota,27,"Kanabec County",27065,268,45,313,0.8562300319
No,Minnesota,27,"Kandiyohi County",27067,970,122,1092,0.8882783883
No,Minnesota,27,"Kittson County",27069,156,28,184,0.847826087
No,Minnesota,27,"Koochiching County",27071,359,51,410,0.8756097561
No,Minnesota,27,"Lac qui Parle County",27073,261,36,297,0.8787878788
No,Minnesota,27,"Lake County",27075,290,43,333,0.8708708709
No,Minnesota,27,"Lake of the Woods County",27077,113,18,131,0.8625954198
No,Minnesota,27,"Le Sueur County",27079,413,73,486,0.8497942387
No,Minnesota,27,"Lincoln County",27081,194,41,235,0.8255319149
No,Minnesota,27,"Lyon County",27083,703,92,795,0.8842767296
No,Minnesota,27,"McLeod County",27085,670,89,759,0.882740448
No,Minnesota,27,"Mahnomen County",27087,106,16,122,0.868852459
No,Minnesota,27,"Marshall County",27089,305,46,351,0.8689458689
No,Minnesota,27,"Martin County",27091,791,108,899,0.8798665184
No,Minnesota,27,"Meeker County",27093,295,59,354,0.8333333333
No,Minnesota,27,"Mille Lacs County",27095,332,68,400,0.83
No,Minnesota,27,"Morrison County",27097,727,98,825,0.8812121212
No,Minnesota,27,"Mower County",27099,896,120,1016,0.8818897638
No,Minnesota,27,"Murray County",27101,384,57,441,0.8707482993
No,Minnesota,27,"Nicollet County",27103,834,88,922,0.9045553145
No,Minnesota,27,"Nobles County",27105,639,70,709,0.9012693935
No,Minnesota,27,"Norman County",27107,234,23,257,0.9105058366
No,Minnesota,27,"Olmsted County",27109,2389,367,2756,0.8668359942
No,Minnesota,27,"Otter Tail County",27111,1856,243,2099,0.884230586
No,Minnesota,27,"Pennington County",27113,326,42,368,0.8858695652
No,Minnesota,27,"Pine County",27115,442,63,505,0.8752475248
No,Minnesota,27,"Pipestone County",27117,314,57,371,0.846361186
No,Minnesota,27,"Polk County",27119,855,122,977,0.8751279427
No,Minnesota,27,"Pope County",27121,423,62,485,0.8721649485
No,Minnesota,27,"Ramsey County",27123,7127,1182,8309,0.8577446143
No,Minnesota,27,"Red Lake County",27125,102,15,117,0.8717948718
No,Minnesota,27,"Redwood County",27127,522,72,594,0.8787878788
No,Minnesota,27,"Renville County",27129,544,66,610,0.8918032787
No,Minnesota,27,"Rice County",27131,867,128,995,0.8713567839
No,Minnesota,27,"Rock County",27133,260,43,303,0.8580858086
No,Minnesota,27,"Roseau County",27135,418,61,479,0.872651357
No,Minnesota,27,"St. Louis County",27137,3310,482,3792,0.8728902954
No,Minnesota,27,"Scott County",27139,1747,287,2034,0.8588987217
No,Minnesota,27,"Sherburne County",27141,1197,165,1362,0.8788546256
No,Minnesota,27,"Sibley County",27143,237,34,271,0.8745387454
No,Minnesota,27,"Stearns County",27145,2628,347,2975,0.8833613445
No,Minnesota,27,"Steele County",27147,1022,110,1132,0.9028268551
No,Minnesota,27,"Stevens County",27149,247,38,285,0.8666666667
No,Minnesota,27,"Swift County",27151,355,29,384,0.9244791667
No,Minnesota,27,"Todd County",27153,524,80,604,0.8675496689
No,Minnesota,27,"Traverse County",27155,108,14,122,0.8852459016
No,Minnesota,27,"Wabasha County",27157,518,74,592,0.875
No,Minnesota,27,"Wadena County",27159,382,56,438,0.8721461187
No,Minnesota,27,"Waseca County",27161,513,62,575,0.892173913
No,Minnesota,27,"Washington County",27163,4321,642,4963,0.8706427564
No,Minnesota,27,"Watonwan County",27165,324,50,374,0.8663101604
No,Minnesota,27,"Wilkin County",27167,210,25,235,0.8936170213
No,Minnesota,27,"Winona County",27169,1201,167,1368,0.8779239766
No,Minnesota,27,"Wright County",27171,2037,288,2325,0.8761290323
No,Minnesota,27,"Yellow Medicine County",27173,225,32,257,0.8754863813
No,Minnesota,27,,27999,.,.,.,0.9019607843
No,Mississippi,28,"Adams County",28001,670,212,882,0.7596371882
No,Mississippi,28,"Alcorn County",28003,1111,275,1386,0.8015873016
No,Mississippi,28,"Amite County",28005,298,90,388,0.7680412371
No,Mississippi,28,"Attala County",28007,420,128,548,0.7664233577
No,Mississippi,28,"Benton County",28009,178,56,234,0.7606837607
No,Mississippi,28,"Bolivar County",28011,669,243,912,0.7335526316
No,Mississippi,28,"Calhoun County",28013,384,99,483,0.7950310559
No,Mississippi,28,"Carroll County",28015,339,86,425,0.7976470588
No,Mississippi,28,"Chickasaw County",28017,446,131,577,0.7729636049
No,Mississippi,28,"Choctaw County",28019,243,65,308,0.788961039
No,Mississippi,28,"Claiborne County",28021,99,40,139,0.7122302158
No,Mississippi,28,"Clarke County",28023,442,126,568,0.7781690141
No,Mississippi,28,"Clay County",28025,523,121,644,0.8121118012
No,Mississippi,28,"Coahoma County",28027,478,139,617,0.7747163695
No,Mississippi,28,"Copiah County",28029,424,124,548,0.7737226277
No,Mississippi,28,"Covington County",28031,380,134,514,0.7392996109
No,Mississippi,28,"DeSoto County",28033,3632,966,4598,0.7899086559
No,Mississippi,28,"Forrest County",28035,1273,319,1592,0.7996231156
No,Mississippi,28,"Franklin County",28037,234,52,286,0.8181818182
No,Mississippi,28,"George County",28039,519,173,692,0.75
No,Mississippi,28,"Greene County",28041,248,81,329,0.7537993921
No,Mississippi,28,"Grenada County",28043,569,147,716,0.7946927374
No,Mississippi,28,"Hancock County",28045,929,221,1150,0.807826087
No,Mississippi,28,"Harrison County",28047,2690,743,3433,0.7835712205
No,Mississippi,28,"Hinds County",28049,3094,928,4022,0.7692690204
No,Mississippi,28,"Holmes County",28051,257,87,344,0.7470930233
No,Mississippi,28,"Humphreys County",28053,150,46,196,0.7653061224
No,Mississippi,28,"Issaquena County",28055,.,.,.,0.8
No,Mississippi,28,"Itawamba County",28057,760,168,928,0.8189655172
No,Mississippi,28,"Jackson County",28059,2736,752,3488,0.7844036697
No,Mississippi,28,"Jasper County",28061,410,136,546,0.7509157509
No,Mississippi,28,"Jefferson County",28063,134,41,175,0.7657142857
No,Mississippi,28,"Jefferson Davis County",28065,249,96,345,0.7217391304
No,Mississippi,28,"Jones County",28067,1673,467,2140,0.7817757009
No,Mississippi,28,"Kemper County",28069,187,53,240,0.7791666667
No,Mississippi,28,"Lafayette County",28071,1056,303,1359,0.7770419426
No,Mississippi,28,"Lamar County",28073,1105,280,1385,0.797833935
No,Mississippi,28,"Lauderdale County",28075,1581,400,1981,0.7980817769
No,Mississippi,28,"Lawrence County",28077,360,105,465,0.7741935484
No,Mississippi,28,"Leake County",28079,386,112,498,0.7751004016
No,Mississippi,28,"Lee County",28081,2219,590,2809,0.7899608402
No,Mississippi,28,"Leflore County",28083,581,168,749,0.7757009346
No,Mississippi,28,"Lincoln County",28085,896,238,1134,0.7901234568
No,Mississippi,28,"Lowndes County",28087,1227,315,1542,0.7957198444
No,Mississippi,28,"Madison County",28089,1870,510,2380,0.7857142857
No,Mississippi,28,"Marion County",28091,645,195,840,0.7678571429
No,Mississippi,28,"Marshall County",28093,725,209,934,0.7762312634
No,Mississippi,28,"Monroe County",28095,1023,284,1307,0.7827084927
No,Mississippi,28,"Montgomery County",28097,303,80,383,0.7911227154
No,Mississippi,28,"Neshoba County",28099,571,169,740,0.7716216216
No,Mississippi,28,"Newton County",28101,481,107,588,0.8180272109
No,Mississippi,28,"Noxubee County",28103,201,51,252,0.7976190476
No,Mississippi,28,"Oktibbeha County",28105,793,233,1026,0.7729044834
No,Mississippi,28,"Panola County",28107,760,225,985,0.7715736041
No,Mississippi,28,"Pearl River County",28109,1257,326,1583,0.7940619078
No,Mississippi,28,"Perry County",28111,258,87,345,0.747826087
No,Mississippi,28,"Pike County",28113,798,214,1012,0.7885375494
No,Mississippi,28,"Pontotoc County",28115,846,208,1054,0.8026565465
No,Mississippi,28,"Prentiss County",28117,827,189,1016,0.813976378
No,Mississippi,28,"Quitman County",28119,137,41,178,0.7696629213
No,Mississippi,28,"Rankin County",28121,2887,773,3660,0.7887978142
No,Mississippi,28,"Scott County",28123,400,151,551,0.7259528131
No,Mississippi,28,"Sharkey County",28125,93,28,121,0.7685950413
No,Mississippi,28,"Simpson County",28127,573,191,764,0.75
No,Mississippi,28,"Smith County",28129,382,93,475,0.8042105263
No,Mississippi,28,"Stone County",28131,359,97,456,0.7872807018
No,Mississippi,28,"Sunflower County",28133,457,169,626,0.7300319489
No,Mississippi,28,"Tallahatchie County",28135,224,77,301,0.7441860465
No,Mississippi,28,"Tate County",28137,720,195,915,0.7868852459
No,Mississippi,28,"Tippah County",28139,658,141,799,0.8235294118
No,Mississippi,28,"Tishomingo County",28141,738,164,902,0.8181818182
No,Mississippi,28,"Tunica County",28143,118,40,158,0.746835443
No,Mississippi,28,"Union County",28145,796,218,1014,0.7850098619
No,Mississippi,28,"Walthall County",28147,372,94,466,0.7982832618
No,Mississippi,28,"Warren County",28149,648,211,859,0.7543655413
No,Mississippi,28,"Washington County",28151,829,281,1110,0.7468468468
No,Mississippi,28,"Wayne County",28153,525,120,645,0.8139534884
No,Mississippi,28,"Webster County",28155,300,82,382,0.7853403141
No,Mississippi,28,"Wilkinson County",28157,154,46,200,0.77
No,Mississippi,28,"Winston County",28159,434,118,552,0.7862318841
No,Mississippi,28,"Yalobusha County",28161,357,125,482,0.7406639004
No,Mississippi,28,"Yazoo County",28163,434,113,547,0.7934186472
No,Mississippi,28,,28999,.,.,.,0.7674418605
No,Missouri,29,"Adair County",29001,734,138,872,0.8417431193
No,Missouri,29,"Andrew County",29003,586,110,696,0.841954023
No,Missouri,29,"Atchison County",29005,278,46,324,0.8580246914
No,Missouri,29,"Audrain County",29007,879,194,1073,0.8191985089
No,Missouri,29,"Barry County",29009,762,169,931,0.8184747583
No,Missouri,29,"Barton County",29011,349,54,403,0.8660049628
No,Missouri,29,"Bates County",29013,464,109,573,0.8097731239
No,Missouri,29,"Benton County",29015,739,180,919,0.8041349293
No,Missouri,29,"Bollinger County",29017,312,64,376,0.829787234
No,Missouri,29,"Boone County",29019,2824,516,3340,0.845508982
No,Missouri,29,"Buchanan County",29021,2462,505,2967,0.8297944051
No,Missouri,29,"Butler County",29023,1053,284,1337,0.7875841436
No,Missouri,29,"Caldwell County",29025,266,63,329,0.8085106383
No,Missouri,29,"Callaway County",29027,1116,226,1342,0.8315946349
No,Missouri,29,"Camden County",29029,1691,309,2000,0.8455
No,Missouri,29,"Cape Girardeau County",29031,2189,447,2636,0.8304248862
No,Missouri,29,"Carroll County",29033,326,50,376,0.8670212766
No,Missouri,29,"Carter County",29035,165,35,200,0.825
No,Missouri,29,"Cass County",29037,1919,435,2354,0.8152081563
No,Missouri,29,"Cedar County",29039,368,79,447,0.8232662192
No,Missouri,29,"Chariton County",29041,317,58,375,0.8453333333
No,Missouri,29,"Christian County",29043,1596,288,1884,0.847133758
No,Missouri,29,"Clark County",29045,264,58,322,0.8198757764
No,Missouri,29,"Clay County",29047,5104,1034,6138,0.8315412186
No,Missouri,29,"Clinton County",29049,623,110,733,0.8499317872
No,Missouri,29,"Cole County",29051,1990,384,2374,0.8382476832
No,Missouri,29,"Cooper County",29053,465,110,575,0.8086956522
No,Missouri,29,"Crawford County",29055,606,148,754,0.8037135279
No,Missouri,29,"Dade County",29057,191,53,244,0.7827868852
No,Missouri,29,"Dallas County",29059,345,76,421,0.8194774347
No,Missouri,29,"Daviess County",29061,285,48,333,0.8558558559
No,Missouri,29,"DeKalb County",29063,321,64,385,0.8337662338
No,Missouri,29,"Dent County",29065,511,123,634,0.8059936909
No,Missouri,29,"Douglas County",29067,217,41,258,0.8410852713
No,Missouri,29,"Dunklin County",29069,813,181,994,0.8179074447
No,Missouri,29,"Franklin County",29071,2320,448,2768,0.838150289
No,Missouri,29,"Gasconade County",29073,525,115,640,0.8203125
No,Missouri,29,"Gentry County",29075,276,44,320,0.8625
No,Missouri,29,"Greene County",29077,5020,994,6014,0.834718989
No,Missouri,29,"Grundy County",29079,414,77,491,0.8431771894
No,Missouri,29,"Harrison County",29081,369,60,429,0.8601398601
No,Missouri,29,"Henry County",29083,720,157,877,0.8209806157
No,Missouri,29,"Hickory County",29085,246,43,289,0.8512110727
No,Missouri,29,"Holt County",29087,174,41,215,0.8093023256
No,Missouri,29,"Howard County",29089,239,53,292,0.8184931507
No,Missouri,29,"Howell County",29091,1132,245,1377,0.8220769789
No,Missouri,29,"Iron County",29093,402,76,478,0.8410041841
No,Missouri,29,"Jackson County",29095,10055,2160,12215,0.8231682358
No,Missouri,29,"Jasper County",29097,2478,550,3028,0.8183619551
No,Missouri,29,"Jefferson County",29099,4434,915,5349,0.8289399888
No,Missouri,29,"Johnson County",29101,863,184,1047,0.8242597899
No,Missouri,29,"Knox County",29103,154,34,188,0.8191489362
No,Missouri,29,"Laclede County",29105,604,124,728,0.8296703297
No,Missouri,29,"Lafayette County",29107,840,173,1013,0.8292201382
No,Missouri,29,"Lawrence County",29109,687,168,855,0.8035087719
No,Missouri,29,"Lewis County",29111,368,60,428,0.8598130841
No,Missouri,29,"Lincoln County",29113,1253,260,1513,0.8281559815
No,Missouri,29,"Linn County",29115,458,92,550,0.8327272727
No,Missouri,29,"Livingston County",29117,523,65,588,0.8894557823
No,Missouri,29,"McDonald County",29119,330,93,423,0.780141844
No,Missouri,29,"Macon County",29121,597,137,734,0.8133514986
No,Missouri,29,"Madison County",29123,405,93,498,0.813253012
No,Missouri,29,"Maries County",29125,269,48,317,0.8485804416
No,Missouri,29,"Marion County",29127,984,178,1162,0.8468158348
No,Missouri,29,"Mercer County",29129,117,18,135,0.8666666667
No,Missouri,29,"Miller County",29131,640,137,777,0.8236808237
No,Missouri,29,"Mississippi County",29133,374,94,468,0.7991452991
No,Missouri,29,"Moniteau County",29135,395,80,475,0.8315789474
No,Missouri,29,"Monroe County",29137,352,66,418,0.8421052632
No,Missouri,29,"Montgomery County",29139,413,77,490,0.8428571429
No,Missouri,29,"Morgan County",29141,619,125,744,0.8319892473
No,Missouri,29,"New Madrid County",29143,480,111,591,0.8121827411
No,Missouri,29,"Newton County",29145,1385,334,1719,0.8057009889
No,Missouri,29,"Nodaway County",29147,692,128,820,0.843902439
No,Missouri,29,"Oregon County",29149,277,71,348,0.7959770115
No,Missouri,29,"Osage County",29151,456,58,514,0.8871595331
No,Missouri,29,"Ozark County",29153,272,60,332,0.8192771084
No,Missouri,29,"Pemiscot County",29155,349,120,469,0.7441364606
No,Missouri,29,"Perry County",29157,633,130,763,0.8296199214
No,Missouri,29,"Pettis County",29159,1123,195,1318,0.8520485584
No,Missouri,29,"Phelps County",29161,969,203,1172,0.8267918089
No,Missouri,29,"Pike County",29163,543,118,661,0.8214826021
No,Missouri,29,"Platte County",29165,2156,438,2594,0.8311488049
No,Missouri,29,"Polk County",29167,591,150,741,0.7975708502
No,Missouri,29,"Pulaski County",29169,342,89,431,0.7935034803
No,Missouri,29,"Putnam County",29171,209,40,249,0.8393574297
No,Missouri,29,"Ralls County",29173,461,75,536,0.8600746269
No,Missouri,29,"Randolph County",29175,706,138,844,0.836492891
No,Missouri,29,"Ray County",29177,793,154,947,0.8373812038
No,Missouri,29,"Reynolds County",29179,207,54,261,0.7931034483
No,Missouri,29,"Ripley County",29181,345,97,442,0.7805429864
No,Missouri,29,"St. Charles County",29183,8444,1470,9914,0.8517248336
No,Missouri,29,"St. Clair County",29185,314,59,373,0.8418230563
No,Missouri,29,"Ste. Genevieve County",29186,656,137,793,0.8272383354
No,Missouri,29,"St. Francois County",29187,2098,417,2515,0.834194831
No,Missouri,29,"St. Louis County",29189,20816,4343,25159,0.8273778767
No,Missouri,29,"Saline County",29195,678,117,795,0.8528301887
No,Missouri,29,"Schuyler County",29197,155,29,184,0.8423913043
No,Missouri,29,"Scotland County",29199,136,43,179,0.7597765363
No,Missouri,29,"Scott County",29201,1174,234,1408,0.8338068182
No,Missouri,29,"Shannon County",29203,163,36,199,0.8190954774
No,Missouri,29,"Shelby County",29205,262,43,305,0.8590163934
No,Missouri,29,"Stoddard County",29207,863,181,1044,0.8266283525
No,Missouri,29,"Stone County",29209,1092,227,1319,0.8278999242
No,Missouri,29,"Sullivan County",29211,229,33,262,0.8740458015
No,Missouri,29,"Taney County",29213,1495,294,1789,0.8356623812
No,Missouri,29,"Texas County",29215,643,126,769,0.8361508453
No,Missouri,29,"Vernon County",29217,556,125,681,0.8164464023
No,Missouri,29,"Warren County",29219,852,168,1020,0.8352941176
No,Missouri,29,"Washington County",29221,648,184,832,0.7788461538
No,Missouri,29,"Wayne County",29223,339,67,406,0.8349753695
No,Missouri,29,"Webster County",29225,570,138,708,0.8050847458
No,Missouri,29,"Worth County",29227,80,16,96,0.8333333333
No,Missouri,29,"Wright County",29229,382,81,463,0.8250539957
No,Missouri,29,"St. Louis city",29510,2784,793,3577,0.7783058429
No,Missouri,29,,29999,73,19,92,0.7934782609
No,Montana,30,"Beaverhead County",30001,289,45,334,0.8652694611
No,Montana,30,"Big Horn County",30003,105,24,129,0.8139534884
No,Montana,30,"Blaine County",30005,110,30,140,0.7857142857
No,Montana,30,"Broadwater County",30007,173,28,201,0.8606965174
No,Montana,30,"Carbon County",30009,219,52,271,0.8081180812
No,Montana,30,"Carter County",30011,37,16,53,0.6981132075
No,Montana,30,"Cascade County",30013,1503,268,1771,0.8486730661
No,Montana,30,"Chouteau County",30015,161,44,205,0.7853658537
No,Montana,30,"Custer County",30017,294,44,338,0.8698224852
No,Montana,30,"Daniels County",30019,.,.,.,0.9166666667
No,Montana,30,"Dawson County",30021,315,63,378,0.8333333333
No,Montana,30,"Deer Lodge County",30023,287,60,347,0.8270893372
No,Montana,30,"Fallon County",30025,98,16,114,0.8596491228
No,Montana,30,"Fergus County",30027,268,70,338,0.7928994083
No,Montana,30,"Flathead County",30029,2099,443,2542,0.8257277734
No,Montana,30,"Gallatin County",30031,1281,251,1532,0.8361618799
No,Montana,30,"Garfield County",30033,.,.,.,0.7826086957
No,Montana,30,"Glacier County",30035,91,33,124,0.7338709677
No,Montana,30,"Golden Valley County",30037,.,.,.,0.7777777778
No,Montana,30,"Granite County",30039,78,21,99,0.7878787879
No,Montana,30,"Hill County",30041,380,72,452,0.8407079646
No,Montana,30,"Jefferson County",30043,252,43,295,0.8542372881
No,Montana,30,"Judith Basin County",30045,49,12,61,0.8032786885
No,Montana,30,"Lake County",30047,614,141,755,0.8132450331
No,Montana,30,"Lewis and Clark County",30049,1531,246,1777,0.8615644344
No,Montana,30,"Liberty County",30051,.,.,.,0.8928571429
No,Montana,30,"Lincoln County",30053,502,125,627,0.8006379585
No,Montana,30,"McCone County",30055,64,18,82,0.7804878049
No,Montana,30,"Madison County",30057,269,47,316,0.8512658228
No,Montana,30,"Meagher County",30059,.,.,.,0.8888888889
No,Montana,30,"Mineral County",30061,144,33,177,0.813559322
No,Montana,30,"Missoula County",30063,2194,373,2567,0.8546941956
No,Montana,30,"Musselshell County",30065,146,22,168,0.869047619
No,Montana,30,"Park County",30067,380,85,465,0.8172043011
No,Montana,30,"Petroleum County",30069,.,.,.,0.8125
No,Montana,30,"Phillips County",30071,103,15,118,0.8728813559
No,Montana,30,"Pondera County",30073,159,34,193,0.8238341969
No,Montana,30,"Powder River County",30075,.,.,.,0.8571428571
No,Montana,30,"Powell County",30077,146,46,192,0.7604166667
No,Montana,30,"Prairie County",30079,49,11,60,0.8166666667
No,Montana,30,"Ravalli County",30081,1092,209,1301,0.8393543428
No,Montana,30,"Richland County",30083,391,84,475,0.8231578947
No,Montana,30,"Roosevelt County",30085,153,42,195,0.7846153846
No,Montana,30,"Rosebud County",30087,167,30,197,0.847715736
No,Montana,30,"Sanders County",30089,375,89,464,0.8081896552
No,Montana,30,"Sheridan County",30091,140,34,174,0.8045977011
No,Montana,30,"Silver Bow County",30093,700,137,837,0.8363201912
No,Montana,30,"Stillwater County",30095,233,49,282,0.8262411348
No,Montana,30,"Sweet Grass County",30097,105,23,128,0.8203125
No,Montana,30,"Teton County",30099,153,19,172,0.8895348837
No,Montana,30,"Toole County",30101,93,22,115,0.8086956522
No,Montana,30,"Treasure County",30103,.,.,.,0.8
No,Montana,30,"Valley County",30105,215,47,262,0.820610687
No,Montana,30,"Wheatland County",30107,.,.,.,0.8983050847
No,Montana,30,"Wibaux County",30109,47,15,62,0.7580645161
No,Montana,30,"Yellowstone County",30111,3149,553,3702,0.8506212858
No,Montana,30,,30999,.,.,.,0.8333333333
No,Nebraska,31,"Adams County",31001,1128,192,1320,0.8545454545
No,Nebraska,31,"Antelope County",31003,427,69,496,0.8608870968
No,Nebraska,31,"Arthur County",31005,.,.,.,0.7894736842
No,Nebraska,31,"Banner County",31007,.,.,.,0.9166666667
No,Nebraska,31,"Blaine County",31009,.,.,.,0.8695652174
No,Nebraska,31,"Boone County",31011,308,55,363,0.8484848485
No,Nebraska,31,"Box Butte County",31013,333,76,409,0.8141809291
No,Nebraska,31,"Boyd County",31015,112,14,126,0.8888888889
No,Nebraska,31,"Brown County",31017,143,26,169,0.8461538462
No,Nebraska,31,"Buffalo County",31019,1390,267,1657,0.8388654194
No,Nebraska,31,"Burt County",31021,321,57,378,0.8492063492
No,Nebraska,31,"Butler County",31023,343,57,400,0.8575
No,Nebraska,31,"Cass County",31025,733,122,855,0.8573099415
No,Nebraska,31,"Cedar County",31027,342,51,393,0.8702290076
No,Nebraska,31,"Chase County",31029,140,24,164,0.8536585366
No,Nebraska,31,"Cherry County",31031,225,35,260,0.8653846154
No,Nebraska,31,"Cheyenne County",31033,276,85,361,0.7645429363
No,Nebraska,31,"Clay County",31035,316,42,358,0.8826815642
No,Nebraska,31,"Colfax County",31037,296,52,348,0.8505747126
No,Nebraska,31,"Cuming County",31039,417,52,469,0.8891257996
No,Nebraska,31,"Custer County",31041,480,110,590,0.813559322
No,Nebraska,31,"Dakota County",31043,415,61,476,0.8718487395
No,Nebraska,31,"Dawes County",31045,209,40,249,0.8393574297
No,Nebraska,31,"Dawson County",31047,697,108,805,0.8658385093
No,Nebraska,31,"Deuel County",31049,79,14,93,0.8494623656
No,Nebraska,31,"Dixon County",31051,201,24,225,0.8933333333
No,Nebraska,31,"Dodge County",31053,1288,232,1520,0.8473684211
No,Nebraska,31,"Douglas County",31055,10644,1853,12497,0.8517244139
No,Nebraska,31,"Dundy County",31057,78,19,97,0.8041237113
No,Nebraska,31,"Fillmore County",31059,293,52,345,0.8492753623
No,Nebraska,31,"Franklin County",31061,149,32,181,0.8232044199
No,Nebraska,31,"Frontier County",31063,112,12,124,0.9032258065
No,Nebraska,31,"Furnas County",31065,245,44,289,0.8477508651
No,Nebraska,31,"Gage County",31067,925,158,1083,0.8541089566
No,Nebraska,31,"Garden County",31069,87,25,112,0.7767857143
No,Nebraska,31,"Garfield County",31071,85,23,108,0.787037037
No,Nebraska,31,"Gosper County",31073,97,18,115,0.8434782609
No,Nebraska,31,"Grant County",31075,.,.,.,0.8571428571
No,Nebraska,31,"Greeley County",31077,108,21,129,0.8372093023
No,Nebraska,31,"Hall County",31079,1622,307,1929,0.8408501814
No,Nebraska,31,"Hamilton County",31081,419,80,499,0.8396793587
No,Nebraska,31,"Harlan County",31083,140,32,172,0.8139534884
No,Nebraska,31,"Hayes County",31085,.,.,.,0.8260869565
No,Nebraska,31,"Hitchcock County",31087,122,30,152,0.8026315789
No,Nebraska,31,"Holt County",31089,579,86,665,0.8706766917
No,Nebraska,31,"Hooker County",31091,33,11,44,0.75
No,Nebraska,31,"Howard County",31093,245,34,279,0.8781362007
No,Nebraska,31,"Jefferson County",31095,330,67,397,0.8312342569
No,Nebraska,31,"Johnson County",31097,186,27,213,0.8732394366
No,Nebraska,31,"Kearney County",31099,260,34,294,0.8843537415
No,Nebraska,31,"Keith County",31101,374,57,431,0.86774942
No,Nebraska,31,"Keya Paha County",31103,.,.,.,0.8039215686
No,Nebraska,31,"Kimball County",31105,146,33,179,0.8156424581
No,Nebraska,31,"Knox County",31107,404,61,465,0.8688172043
No,Nebraska,31,"Lancaster County",31109,7723,1258,8981,0.8599265115
No,Nebraska,31,"Lincoln County",31111,1098,317,1415,0.7759717314
No,Nebraska,31,"Logan County",31113,23,11,34,0.6764705882
No,Nebraska,31,"Loup County",31115,.,.,.,0.8947368421
No,Nebraska,31,"McPherson County",31117,.,.,.,0.8888888889
No,Nebraska,31,"Madison County",31119,1162,192,1354,0.8581979321
No,Nebraska,31,"Merrick County",31121,290,53,343,0.8454810496
No,Nebraska,31,"Morrill County",31123,82,18,100,0.82
No,Nebraska,31,"Nance County",31125,157,30,187,0.8395721925
No,Nebraska,31,"Nemaha County",31127,288,53,341,0.8445747801
No,Nebraska,31,"Nuckolls County",31129,225,32,257,0.8754863813
No,Nebraska,31,"Otoe County",31131,599,102,701,0.8544935806
No,Nebraska,31,"Pawnee County",31133,133,26,159,0.8364779874
No,Nebraska,31,"Perkins County",31135,160,24,184,0.8695652174
No,Nebraska,31,"Phelps County",31137,404,83,487,0.8295687885
No,Nebraska,31,"Pierce County",31139,313,53,366,0.8551912568
No,Nebraska,31,"Platte County",31141,1491,197,1688,0.8832938389
No,Nebraska,31,"Polk County",31143,303,38,341,0.8885630499
No,Nebraska,31,"Red Willow County",31145,442,68,510,0.8666666667
No,Nebraska,31,"Richardson County",31147,425,93,518,0.8204633205
No,Nebraska,31,"Rock County",31149,85,13,98,0.8673469388
No,Nebraska,31,"Saline County",31151,447,97,544,0.8216911765
No,Nebraska,31,"Sarpy County",31153,2969,496,3465,0.8568542569
No,Nebraska,31,"Saunders County",31155,700,130,830,0.843373494
No,Nebraska,31,"Scotts Bluff County",31157,1071,220,1291,0.8295894655
No,Nebraska,31,"Seward County",31159,646,102,748,0.8636363636
No,Nebraska,31,"Sheridan County",31161,184,40,224,0.8214285714
No,Nebraska,31,"Sherman County",31163,132,29,161,0.8198757764
No,Nebraska,31,"Sioux County",31165,.,.,.,0.8863636364
No,Nebraska,31,"Stanton County",31167,203,38,241,0.8423236515
No,Nebraska,31,"Thayer County",31169,285,51,336,0.8482142857
No,Nebraska,31,"Thomas County",31171,32,11,43,0.7441860465
No,Nebraska,31,"Thurston County",31173,120,20,140,0.8571428571
No,Nebraska,31,"Valley County",31175,200,43,243,0.8230452675
No,Nebraska,31,"Washington County",31177,680,100,780,0.8717948718
No,Nebraska,31,"Wayne County",31179,282,43,325,0.8676923077
No,Nebraska,31,"Webster County",31181,181,33,214,0.8457943925
No,Nebraska,31,"Wheeler County",31183,40,13,53,0.7547169811
No,Nebraska,31,"York County",31185,620,97,717,0.8647140865
No,Nebraska,31,,31999,.,.,.,0.75
No,Nevada,32,"Churchill County",32001,505,132,637,0.7927786499
No,Nevada,32,"Clark County",32003,22301,5859,28160,0.7919389205
No,Nevada,32,"Douglas County",32005,1610,351,1961,0.8210096889
No,Nevada,32,"Elko County",32007,405,153,558,0.7258064516
No,Nevada,32,"Esmeralda County",32009,.,.,.,0.7272727273
No,Nevada,32,"Eureka County",32011,.,.,.,0.6470588235
No,Nevada,32,"Humboldt County",32013,252,68,320,0.7875
No,Nevada,32,"Lander County",32015,65,19,84,0.7738095238
No,Nevada,32,"Lincoln County",32017,120,28,148,0.8108108108
No,Nevada,32,"Lyon County",32019,1179,251,1430,0.8244755245
No,Nevada,32,"Mineral County",32021,97,20,117,0.8290598291
No,Nevada,32,"Nye County",32023,948,235,1183,0.8013524937
No,Nevada,32,"Pershing County",32027,79,23,102,0.7745098039
No,Nevada,32,"Storey County",32029,84,19,103,0.8155339806
No,Nevada,32,"Washoe County",32031,6016,1402,7418,0.8110002696
No,Nevada,32,"White Pine County",32033,191,48,239,0.7991631799
No,Nevada,32,"Carson City",32510,1258,267,1525,0.8249180328
No,Nevada,32,,32999,.,.,.,0.8214285714
No,"New Hampshire",33,"Belknap County",33001,2384,398,2782,0.8569374551
No,"New Hampshire",33,"Carroll County",33003,2177,354,2531,0.8601343343
No,"New Hampshire",33,"Cheshire County",33005,2163,317,2480,0.8721774194
No,"New Hampshire",33,"Coos County",33007,1182,190,1372,0.861516035
No,"New Hampshire",33,"Grafton County",33009,2548,422,2970,0.8579124579
No,"New Hampshire",33,"Hillsborough County",33011,9842,1589,11431,0.8609920392
No,"New Hampshire",33,"Merrimack County",33013,4568,740,5308,0.860587792
No,"New Hampshire",33,"Rockingham County",33015,9006,1415,10421,0.8642164859
No,"New Hampshire",33,"Strafford County",33017,2605,474,3079,0.8460539136
No,"New Hampshire",33,"Sullivan County",33019,1441,239,1680,0.8577380952
No,"New Hampshire",33,,33999,.,.,.,0.6666666667
No,"New Jersey",34,"Atlantic County",34001,8406,1735,10141,0.8289123361
No,"New Jersey",34,"Bergen County",34003,22078,4460,26538,0.8319391062
No,"New Jersey",34,"Burlington County",34005,12008,2237,14245,0.842962443
No,"New Jersey",34,"Camden County",34007,11002,2205,13207,0.8330430832
No,"New Jersey",34,"Cape May County",34009,4729,838,5567,0.8494700916
No,"New Jersey",34,"Cumberland County",34011,3640,740,4380,0.8310502283
No,"New Jersey",34,"Essex County",34013,10447,2839,13286,0.7863164233
No,"New Jersey",34,"Gloucester County",34015,7816,1341,9157,0.8535546576
No,"New Jersey",34,"Hudson County",34017,5905,1713,7618,0.7751378315
No,"New Jersey",34,"Hunterdon County",34019,3960,664,4624,0.8564013841
No,"New Jersey",34,"Mercer County",34021,8380,1693,10073,0.8319269334
No,"New Jersey",34,"Middlesex County",34023,17437,3737,21174,0.8235099651
No,"New Jersey",34,"Monmouth County",34025,17679,3609,21288,0.8304678692
No,"New Jersey",34,"Morris County",34027,12833,2421,15254,0.8412875311
No,"New Jersey",34,"Ocean County",34029,25147,4615,29762,0.8449364962
No,"New Jersey",34,"Passaic County",34031,9231,2058,11289,0.8176986447
No,"New Jersey",34,"Salem County",34033,2161,390,2551,0.847118777
No,"New Jersey",34,"Somerset County",34035,7997,1552,9549,0.8374698921
No,"New Jersey",34,"Sussex County",34037,4496,812,5308,0.847023361
No,"New Jersey",34,"Union County",34039,9799,2193,11992,0.8171280854
No,"New Jersey",34,"Warren County",34041,3709,723,4432,0.836868231
No,"New Jersey",34,,34999,72,19,91,0.7912087912
No,"New Mexico",35,"Bernalillo County",35001,4840,1106,5946,0.8139926001
No,"New Mexico",35,"Catron County",35003,84,21,105,0.8
No,"New Mexico",35,"Chaves County",35005,1180,289,1469,0.8032675289
No,"New Mexico",35,"Cibola County",35006,232,50,282,0.8226950355
No,"New Mexico",35,"Colfax County",35007,217,55,272,0.7977941176
No,"New Mexico",35,"Curry County",35009,744,153,897,0.8294314381
No,"New Mexico",35,"DeBaca County",35011,56,11,67,0.8358208955
No,"New Mexico",35,"Dona Ana County",35013,2473,564,3037,0.8142904182
No,"New Mexico",35,"Eddy County",35015,1119,298,1417,0.789696542
No,"New Mexico",35,"Grant County",35017,519,143,662,0.7839879154
No,"New Mexico",35,"Guadalupe County",35019,57,14,71,0.8028169014
No,"New Mexico",35,"Harding County",35021,.,.,.,0.8461538462
No,"New Mexico",35,"Hidalgo County",35023,86,14,100,0.86
No,"New Mexico",35,"Lea County",35025,997,274,1271,0.7844217152
No,"New Mexico",35,"Lincoln County",35027,493,118,611,0.8068739771
No,"New Mexico",35,"Los Alamos County",35028,86,21,107,0.8037383178
No,"New Mexico",35,"Luna County",35029,421,105,526,0.8003802281
No,"New Mexico",35,"McKinley County",35031,273,83,356,0.7668539326
No,"New Mexico",35,"Mora County",35033,59,20,79,0.746835443
No,"New Mexico",35,"Otero County",35035,690,201,891,0.7744107744
No,"New Mexico",35,"Quay County",35037,234,61,295,0.793220339
No,"New Mexico",35,"Rio Arriba County",35039,348,85,433,0.8036951501
No,"New Mexico",35,"Roosevelt County",35041,349,86,435,0.8022988506
No,"New Mexico",35,"Sandoval County",35043,1398,330,1728,0.8090277778
No,"New Mexico",35,"San Juan County",35045,1629,472,2101,0.7753450738
No,"New Mexico",35,"San Miguel County",35047,361,118,479,0.7536534447
No,"New Mexico",35,"Santa Fe County",35049,1966,600,2566,0.766173032
No,"New Mexico",35,"Sierra County",35051,248,76,324,0.7654320988
No,"New Mexico",35,"Socorro County",35053,155,58,213,0.7276995305
No,"New Mexico",35,"Taos County",35055,418,123,541,0.7726432532
No,"New Mexico",35,"Torrance County",35057,112,36,148,0.7567567568
No,"New Mexico",35,"Union County",35059,99,30,129,0.7674418605
No,"New Mexico",35,"Valencia County",35061,599,148,747,0.8018741633
No,"New Mexico",35,,35999,.,.,.,0.7368421053
No,"New York",36,"Albany County",36001,5009,768,5777,0.8670590272
No,"New York",36,"Allegany County",36003,992,170,1162,0.8537005164
No,"New York",36,"Bronx County",36005,6426,1946,8372,0.7675585284
No,"New York",36,"Broome County",36007,4841,764,5605,0.8636931311
No,"New York",36,"Cattaraugus County",36009,1266,236,1502,0.8428761651
No,"New York",36,"Cayuga County",36011,1583,257,1840,0.860326087
No,"New York",36,"Chautauqua County",36013,2830,469,3299,0.8578357078
No,"New York",36,"Chemung County",36015,1890,301,2191,0.8626198083
No,"New York",36,"Chenango County",36017,1091,183,1274,0.8563579278
No,"New York",36,"Clinton County",36019,1955,365,2320,0.8426724138
No,"New York",36,"Columbia County",36021,1462,263,1725,0.8475362319
No,"New York",36,"Cortland County",36023,704,126,830,0.8481927711
No,"New York",36,"Delaware County",36025,1540,263,1803,0.8541320022
No,"New York",36,"Dutchess County",36027,7523,1422,8945,0.8410285075
No,"New York",36,"Erie County",36029,10725,1925,12650,0.847826087
No,"New York",36,"Essex County",36031,987,174,1161,0.850129199
No,"New York",36,"Franklin County",36033,1244,182,1426,0.8723702665
No,"New York",36,"Fulton County",36035,1096,176,1272,0.8616352201
No,"New York",36,"Genesee County",36037,875,161,1036,0.8445945946
No,"New York",36,"Greene County",36039,1192,242,1434,0.8312412831
No,"New York",36,"Hamilton County",36041,190,31,221,0.8597285068
No,"New York",36,"Herkimer County",36043,1282,206,1488,0.8615591398
No,"New York",36,"Jefferson County",36045,1930,309,2239,0.8619919607
No,"New York",36,"Kings County",36047,17272,5374,22646,0.7626953987
No,"New York",36,"Lewis County",36049,669,84,753,0.8884462151
No,"New York",36,"Livingston County",36051,786,136,922,0.852494577
No,"New York",36,"Madison County",36053,1210,190,1400,0.8642857143
No,"New York",36,"Monroe County",36055,6087,1140,7227,0.8422581984
No,"New York",36,"Montgomery County",36057,1053,169,1222,0.8617021277
No,"New York",36,"Nassau County",36059,33930,7001,40931,0.828956048
No,"New York",36,"New York County",36061,15092,4312,19404,0.7777777778
No,"New York",36,"Niagara County",36063,3553,563,4116,0.8632167153
No,"New York",36,"Oneida County",36065,4293,748,5041,0.8516167427
No,"New York",36,"Onondaga County",36067,8461,1443,9904,0.8543012924
No,"New York",36,"Ontario County",36069,1469,224,1693,0.8676904903
No,"New York",36,"Orange County",36071,8168,1698,9866,0.8278937766
No,"New York",36,"Orleans County",36073,733,140,873,0.8396334479
No,"New York",36,"Oswego County",36075,2421,413,2834,0.8542695836
No,"New York",36,"Otsego County",36077,1715,268,1983,0.8648512355
No,"New York",36,"Putnam County",36079,2592,510,3102,0.835589942
No,"New York",36,"Queens County",36081,20492,5197,25689,0.7976955117
No,"New York",36,"Rensselaer County",36083,2572,446,3018,0.8522200133
No,"New York",36,"Richmond County",36085,7166,1480,8646,0.8288225769
No,"New York",36,"Rockland County",36087,6843,1336,8179,0.8366548478
No,"New York",36,"St. Lawrence County",36089,2757,435,3192,0.8637218045
No,"New York",36,"Saratoga County",36091,4531,690,5221,0.8678414097
No,"New York",36,"Schenectady County",36093,2338,465,2803,0.8341063147
No,"New York",36,"Schoharie County",36095,810,114,924,0.8766233766
No,"New York",36,"Schuyler County",36097,493,70,563,0.8756660746
No,"New York",36,"Seneca County",36099,703,124,827,0.8500604595
No,"New York",36,"Steuben County",36101,2381,423,2804,0.8491440799
No,"New York",36,"Suffolk County",36103,44025,8663,52688,0.835579259
No,"New York",36,"Sullivan County",36105,2089,447,2536,0.8237381703
No,"New York",36,"Tioga County",36107,1281,213,1494,0.8574297189
No,"New York",36,"Tompkins County",36109,1379,243,1622,0.8501849568
No,"New York",36,"Ulster County",36111,4481,904,5385,0.8321262767
No,"New York",36,"Warren County",36113,1328,235,1563,0.8496481126
No,"New York",36,"Washington County",36115,1181,182,1363,0.8664710198
No,"New York",36,"Wayne County",36117,1025,205,1230,0.8333333333
No,"New York",36,"Westchester County",36119,20124,4017,24141,0.8336025848
No,"New York",36,"Wyoming County",36121,668,127,795,0.8402515723
No,"New York",36,"Yates County",36123,387,60,447,0.8657718121
No,"New York",36,,36999,81,12,93,0.8709677419
No,"North Carolina",37,"Alamance County",37001,2630,554,3184,0.8260050251
No,"North Carolina",37,"Alexander County",37003,927,239,1166,0.795025729
No,"North Carolina",37,"Alleghany County",37005,314,81,395,0.7949367089
No,"North Carolina",37,"Anson County",37007,584,144,728,0.8021978022
No,"North Carolina",37,"Ashe County",37009,888,204,1092,0.8131868132
No,"North Carolina",37,"Avery County",37011,453,98,551,0.8221415608
No,"North Carolina",37,"Beaufort County",37013,1576,328,1904,0.8277310924
No,"North Carolina",37,"Bertie County",37015,564,158,722,0.7811634349
No,"North Carolina",37,"Bladen County",37017,803,244,1047,0.7669531996
No,"North Carolina",37,"Brunswick County",37019,6360,1148,7508,0.8470964305
No,"North Carolina",37,"Buncombe County",37021,5530,1072,6602,0.8376249621
No,"North Carolina",37,"Burke County",37023,2025,439,2464,0.8218344156
No,"North Carolina",37,"Cabarrus County",37025,3379,757,4136,0.8169729207
No,"North Carolina",37,"Caldwell County",37027,1852,426,2278,0.8129938543
No,"North Carolina",37,"Camden County",37029,212,45,257,0.8249027237
No,"North Carolina",37,"Carteret County",37031,1953,393,2346,0.8324808184
No,"North Carolina",37,"Caswell County",37033,483,104,587,0.8228279387
No,"North Carolina",37,"Catawba County",37035,3489,701,4190,0.8326968974
No,"North Carolina",37,"Chatham County",37037,2074,394,2468,0.840356564
No,"North Carolina",37,"Cherokee County",37039,985,239,1224,0.8047385621
No,"North Carolina",37,"Chowan County",37041,434,115,549,0.7905282332
No,"North Carolina",37,"Clay County",37043,378,85,463,0.8164146868
No,"North Carolina",37,"Cleveland County",37045,2729,610,3339,0.817310572
No,"North Carolina",37,"Columbus County",37047,1484,430,1914,0.7753396029
No,"North Carolina",37,"Craven County",37049,2471,622,3093,0.7989007436
No,"North Carolina",37,"Cumberland County",37051,3074,896,3970,0.7743073048
No,"North Carolina",37,"Currituck County",37053,595,128,723,0.8229598893
No,"North Carolina",37,"Dare County",37055,1214,215,1429,0.8495451365
No,"North Carolina",37,"Davidson County",37057,3029,681,3710,0.8164420485
No,"North Carolina",37,"Davie County",37059,919,207,1126,0.8161634103
No,"North Carolina",37,"Duplin County",37061,1205,287,1492,0.8076407507
No,"North Carolina",37,"Durham County",37063,4392,1001,5393,0.8143890228
No,"North Carolina",37,"Edgecombe County",37065,1236,346,1582,0.781289507
No,"North Carolina",37,"Forsyth County",37067,5278,1040,6318,0.8353909465
No,"North Carolina",37,"Franklin County",37069,1326,353,1679,0.789755807
No,"North Carolina",37,"Gaston County",37071,4158,967,5125,0.8113170732
No,"North Carolina",37,"Gates County",37073,258,60,318,0.8113207547
No,"North Carolina",37,"Graham County",37075,211,51,262,0.8053435115
No,"North Carolina",37,"Granville County",37077,1374,272,1646,0.8347509113
No,"North Carolina",37,"Greene County",37079,447,116,563,0.7939609236
No,"North Carolina",37,"Guilford County",37081,7286,1563,8849,0.8233698723
No,"North Carolina",37,"Halifax County",37083,1274,384,1658,0.7683956574
No,"North Carolina",37,"Harnett County",37085,2054,562,2616,0.7851681957
No,"North Carolina",37,"Haywood County",37087,1890,389,2279,0.8293111014
No,"North Carolina",37,"Henderson County",37089,3569,749,4318,0.8265400648
No,"North Carolina",37,"Hertford County",37091,485,141,626,0.7747603834
No,"North Carolina",37,"Hoke County",37093,390,135,525,0.7428571429
No,"North Carolina",37,"Hyde County",37095,115,23,138,0.8333333333
No,"North Carolina",37,"Iredell County",37097,3649,862,4511,0.8089115495
No,"North Carolina",37,"Jackson County",37099,857,205,1062,0.8069679849
No,"North Carolina",37,"Johnston County",37101,4048,983,5031,0.8046114093
No,"North Carolina",37,"Jones County",37103,257,63,320,0.803125
No,"North Carolina",37,"Lee County",37105,1431,305,1736,0.8243087558
No,"North Carolina",37,"Lenoir County",37107,1571,502,2073,0.7578388808
No,"North Carolina",37,"Lincoln County",37109,2227,465,2692,0.8272659733
No,"North Carolina",37,"McDowell County",37111,1129,255,1384,0.8157514451
No,"North Carolina",37,"Macon County",37113,1370,289,1659,0.8257986739
No,"North Carolina",37,"Madison County",37115,518,89,607,0.8533772652
No,"North Carolina",37,"Martin County",37117,781,219,1000,0.781
No,"North Carolina",37,"Mecklenburg County",37119,12377,2778,15155,0.8166941603
No,"North Carolina",37,"Mitchell County",37121,422,94,516,0.8178294574
No,"North Carolina",37,"Montgomery County",37123,628,147,775,0.8103225806
No,"North Carolina",37,"Moore County",37125,2886,638,3524,0.8189557321
No,"North Carolina",37,"Nash County",37127,2525,650,3175,0.7952755906
No,"North Carolina",37,"New Hanover County",37129,5550,1179,6729,0.82478823
No,"North Carolina",37,"Northampton County",37131,582,172,754,0.7718832891
No,"North Carolina",37,"Onslow County",37133,1957,458,2415,0.8103519669
No,"North Carolina",37,"Orange County",37135,2112,429,2541,0.8311688312
No,"North Carolina",37,"Pamlico County",37137,484,96,580,0.8344827586
No,"North Carolina",37,"Pasquotank County",37139,835,225,1060,0.7877358491
No,"North Carolina",37,"Pender County",37141,1480,355,1835,0.8065395095
No,"North Carolina",37,"Perquimans County",37143,465,113,578,0.8044982699
No,"North Carolina",37,"Person County",37145,1045,225,1270,0.8228346457
No,"North Carolina",37,"Pitt County",37147,3000,769,3769,0.7959671
No,"North Carolina",37,"Polk County",37149,717,160,877,0.8175598632
No,"North Carolina",37,"Randolph County",37151,2549,561,3110,0.8196141479
No,"North Carolina",37,"Richmond County",37153,1022,265,1287,0.7940947941
No,"North Carolina",37,"Robeson County",37155,2067,651,2718,0.7604856512
No,"North Carolina",37,"Rockingham County",37157,1789,390,2179,0.821018816
No,"North Carolina",37,"Rowan County",37159,2724,611,3335,0.8167916042
No,"North Carolina",37,"Rutherford County",37161,1854,445,2299,0.8064375816
No,"North Carolina",37,"Sampson County",37163,1459,346,1805,0.8083102493
No,"North Carolina",37,"Scotland County",37165,849,216,1065,0.7971830986
No,"North Carolina",37,"Stanly County",37167,1712,394,2106,0.8129154796
No,"North Carolina",37,"Stokes County",37169,818,159,977,0.8372569089
No,"North Carolina",37,"Surry County",37171,1599,291,1890,0.846031746
No,"North Carolina",37,"Swain County",37173,297,115,412,0.7208737864
No,"North Carolina",37,"Transylvania County",37175,1162,200,1362,0.8531571219
No,"North Carolina",37,"Tyrrell County",37177,83,13,96,0.8645833333
No,"North Carolina",37,"Union County",37179,3886,844,4730,0.821564482
No,"North Carolina",37,"Vance County",37181,894,209,1103,0.8105167724
No,"North Carolina",37,"Wake County",37183,15423,3346,18769,0.8217273163
No,"North Carolina",37,"Warren County",37185,452,103,555,0.8144144144
No,"North Carolina",37,"Washington County",37187,385,108,493,0.7809330629
No,"North Carolina",37,"Watauga County",37189,1023,226,1249,0.8190552442
No,"North Carolina",37,"Wayne County",37191,2305,647,2952,0.7808265583
No,"North Carolina",37,"Wilkes County",37193,1891,362,2253,0.839325344
No,"North Carolina",37,"Wilson County",37195,1906,489,2395,0.7958246347
No,"North Carolina",37,"Yadkin County",37197,758,137,895,0.8469273743
No,"North Carolina",37,"Yancey County",37199,478,90,568,0.8415492958
No,"North Carolina",37,,37999,101,18,119,0.8487394958
No,"North Dakota",38,"Adams County",38001,126,17,143,0.8811188811
No,"North Dakota",38,"Barnes County",38003,406,45,451,0.9002217295
No,"North Dakota",38,"Benson County",38005,161,33,194,0.8298969072
No,"North Dakota",38,"Billings County",38007,.,.,.,0.9166666667
No,"North Dakota",38,"Bottineau County",38009,287,37,324,0.8858024691
No,"North Dakota",38,"Bowman County",38011,134,19,153,0.8758169935
No,"North Dakota",38,"Burke County",38013,84,15,99,0.8484848485
No,"North Dakota",38,"Burleigh County",38015,2730,367,3097,0.8814982241
No,"North Dakota",38,"Cass County",38017,3086,393,3479,0.8870365047
No,"North Dakota",38,"Cavalier County",38019,253,24,277,0.9133574007
No,"North Dakota",38,"Dickey County",38021,202,26,228,0.8859649123
No,"North Dakota",38,"Divide County",38023,109,12,121,0.9008264463
No,"North Dakota",38,"Dunn County",38025,128,21,149,0.8590604027
No,"North Dakota",38,"Eddy County",38027,110,26,136,0.8088235294
No,"North Dakota",38,"Emmons County",38029,170,20,190,0.8947368421
No,"North Dakota",38,"Foster County",38031,158,24,182,0.8681318681
No,"North Dakota",38,"Golden Valley County",38033,75,12,87,0.8620689655
No,"North Dakota",38,"Grand Forks County",38035,1457,208,1665,0.8750750751
No,"North Dakota",38,"Grant County",38037,128,18,146,0.8767123288
No,"North Dakota",38,"Griggs County",38039,126,24,150,0.84
No,"North Dakota",38,"Hettinger County",38041,110,17,127,0.8661417323
No,"North Dakota",38,"Kidder County",38043,122,19,141,0.865248227
No,"North Dakota",38,"LaMoure County",38045,218,20,238,0.9159663866
No,"North Dakota",38,"Logan County",38047,81,11,92,0.8804347826
No,"North Dakota",38,"McHenry County",38049,201,30,231,0.8701298701
No,"North Dakota",38,"McIntosh County",38051,191,21,212,0.9009433962
No,"North Dakota",38,"McKenzie County",38053,214,28,242,0.8842975207
No,"North Dakota",38,"McLean County",38055,443,73,516,0.8585271318
No,"North Dakota",38,"Mercer County",38057,273,54,327,0.8348623853
No,"North Dakota",38,"Morton County",38059,1002,132,1134,0.8835978836
No,"North Dakota",38,"Mountrail County",38061,211,48,259,0.8146718147
No,"North Dakota",38,"Nelson County",38063,157,25,182,0.8626373626
No,"North Dakota",38,"Oliver County",38065,.,.,.,0.8875
No,"North Dakota",38,"Pembina County",38067,361,43,404,0.8935643564
No,"North Dakota",38,"Pierce County",38069,222,26,248,0.8951612903
No,"North Dakota",38,"Ramsey County",38071,495,58,553,0.8951175407
No,"North Dakota",38,"Ransom County",38073,230,40,270,0.8518518519
No,"North Dakota",38,"Renville County",38075,103,13,116,0.8879310345
No,"North Dakota",38,"Richland County",38077,493,53,546,0.9029304029
No,"North Dakota",38,"Rolette County",38079,190,24,214,0.8878504673
No,"North Dakota",38,"Sargent County",38081,185,27,212,0.8726415094
No,"North Dakota",38,"Sheridan County",38083,.,.,.,0.9186046512
No,"North Dakota",38,"Sioux County",38085,.,.,.,0.8823529412
No,"North Dakota",38,"Slope County",38087,.,.,.,0.9090909091
No,"North Dakota",38,"Stark County",38089,905,118,1023,0.8846529814
No,"North Dakota",38,"Steele County",38091,.,.,.,0.9306930693
No,"North Dakota",38,"Stutsman County",38093,630,77,707,0.8910891089
No,"North Dakota",38,"Towner County",38095,117,12,129,0.9069767442
No,"North Dakota",38,"Traill County",38097,315,37,352,0.8948863636
No,"North Dakota",38,"Walsh County",38099,457,56,513,0.8908382066
No,"North Dakota",38,"Ward County",38101,1544,250,1794,0.8606465998
No,"North Dakota",38,"Wells County",38103,252,42,294,0.8571428571
No,"North Dakota",38,"Williams County",38105,590,116,706,0.835694051
No,"North Dakota",38,,38999,.,.,.,0.8571428571
No,Ohio,39,"Adams County",39001,548,158,706,0.776203966
No,Ohio,39,"Allen County",39003,3505,628,4133,0.8480522623
No,Ohio,39,"Ashland County",39005,1404,221,1625,0.864
No,Ohio,39,"Ashtabula County",39007,2875,550,3425,0.8394160584
No,Ohio,39,"Athens County",39009,960,203,1163,0.8254514187
No,Ohio,39,"Auglaize County",39011,1836,329,2165,0.8480369515
No,Ohio,39,"Belmont County",39013,1362,283,1645,0.8279635258
No,Ohio,39,"Brown County",39015,834,189,1023,0.8152492669
No,Ohio,39,"Butler County",39017,6787,1532,8319,0.8158432504
No,Ohio,39,"Carroll County",39019,621,119,740,0.8391891892
No,Ohio,39,"Champaign County",39021,881,167,1048,0.840648855
No,Ohio,39,"Clark County",39023,2409,574,2983,0.8075762655
No,Ohio,39,"Clermont County",39025,3510,737,4247,0.8264657405
No,Ohio,39,"Clinton County",39027,860,187,1047,0.8213944604
No,Ohio,39,"Columbiana County",39029,2504,492,2996,0.8357810414
No,Ohio,39,"Coshocton County",39031,1193,210,1403,0.8503207413
No,Ohio,39,"Crawford County",39033,1571,301,1872,0.8392094017
No,Ohio,39,"Cuyahoga County",39035,24666,4887,29553,0.8346360776
No,Ohio,39,"Darke County",39037,1543,288,1831,0.8427089022
No,Ohio,39,"Defiance County",39039,1552,266,1818,0.8536853685
No,Ohio,39,"Delaware County",39041,3668,680,4348,0.8436062557
No,Ohio,39,"Erie County",39043,2662,511,3173,0.8389536716
No,Ohio,39,"Fairfield County",39045,2711,554,3265,0.8303215926
No,Ohio,39,"Fayette County",39047,594,115,709,0.8377997179
No,Ohio,39,"Franklin County",39049,15167,3209,18376,0.8253700479
No,Ohio,39,"Fulton County",39051,1487,286,1773,0.8386914834
No,Ohio,39,"Gallia County",39053,838,190,1028,0.8151750973
No,Ohio,39,"Geauga County",39055,2581,436,3017,0.8554855817
No,Ohio,39,"Greene County",39057,2567,576,3143,0.8167356029
No,Ohio,39,"Guernsey County",39059,1158,239,1397,0.8289191124
No,Ohio,39,"Hamilton County",39061,11968,2678,14646,0.8171514407
No,Ohio,39,"Hancock County",39063,2071,394,2465,0.8401622718
No,Ohio,39,"Hardin County",39065,1001,206,1207,0.8293289147
No,Ohio,39,"Harrison County",39067,453,93,546,0.8296703297
No,Ohio,39,"Henry County",39069,1103,206,1309,0.8426279603
No,Ohio,39,"Highland County",39071,958,212,1170,0.8188034188
No,Ohio,39,"Hocking County",39073,781,146,927,0.8425026969
No,Ohio,39,"Holmes County",39075,548,85,633,0.8657187994
No,Ohio,39,"Huron County",39077,1940,338,2278,0.8516242318
No,Ohio,39,"Jackson County",39079,781,177,958,0.8152400835
No,Ohio,39,"Jefferson County",39081,2077,464,2541,0.8173947265
No,Ohio,39,"Knox County",39083,1512,342,1854,0.8155339806
No,Ohio,39,"Lake County",39085,6630,1229,7859,0.843618781
No,Ohio,39,"Lawrence County",39087,1654,401,2055,0.80486618
No,Ohio,39,"Licking County",39089,3444,603,4047,0.8510007413
No,Ohio,39,"Logan County",39091,1476,258,1734,0.8512110727
No,Ohio,39,"Lorain County",39093,9279,1830,11109,0.8352687011
No,Ohio,39,"Lucas County",39095,9492,2209,11701,0.8112127169
No,Ohio,39,"Madison County",39097,831,174,1005,0.8268656716
No,Ohio,39,"Mahoning County",39099,5596,1052,6648,0.8417569194
No,Ohio,39,"Marion County",39101,1688,349,2037,0.8286696122
No,Ohio,39,"Medina County",39103,4533,779,5312,0.8533509036
No,Ohio,39,"Meigs County",39105,619,128,747,0.828647925
No,Ohio,39,"Mercer County",39107,1601,254,1855,0.8630727763
No,Ohio,39,"Miami County",39109,2564,504,3068,0.8357235984
No,Ohio,39,"Monroe County",39111,405,53,458,0.884279476
No,Ohio,39,"Montgomery County",39113,8910,2042,10952,0.8135500365
No,Ohio,39,"Morgan County",39115,370,76,446,0.8295964126
No,Ohio,39,"Morrow County",39117,875,186,1061,0.8246936852
No,Ohio,39,"Muskingum County",39119,2544,468,3012,0.8446215139
No,Ohio,39,"Noble County",39121,400,68,468,0.8547008547
No,Ohio,39,"Ottawa County",39123,1763,348,2111,0.8351492184
No,Ohio,39,"Paulding County",39125,740,113,853,0.8675263775
No,Ohio,39,"Perry County",39127,832,150,982,0.8472505092
No,Ohio,39,"Pickaway County",39129,1105,224,1329,0.8314522197
No,Ohio,39,"Pike County",39131,592,144,736,0.8043478261
No,Ohio,39,"Portage County",39133,3374,607,3981,0.8475257473
No,Ohio,39,"Preble County",39135,1103,203,1306,0.8445635528
No,Ohio,39,"Putnam County",39137,1400,257,1657,0.8449004225
No,Ohio,39,"Richland County",39139,3809,717,4526,0.8415819708
No,Ohio,39,"Ross County",39141,1572,320,1892,0.8308668076
No,Ohio,39,"Sandusky County",39143,2095,403,2498,0.8386709367
No,Ohio,39,"Scioto County",39145,2008,577,2585,0.7767891683
No,Ohio,39,"Seneca County",39147,1953,366,2319,0.8421733506
No,Ohio,39,"Shelby County",39149,1448,272,1720,0.8418604651
No,Ohio,39,"Stark County",39151,7473,1393,8866,0.8428829235
No,Ohio,39,"Summit County",39153,10099,1901,12000,0.8415833333
No,Ohio,39,"Trumbull County",39155,5905,1159,7064,0.8359286523
No,Ohio,39,"Tuscarawas County",39157,2074,373,2447,0.8475684512
No,Ohio,39,"Union County",39159,1186,191,1377,0.8612926652
No,Ohio,39,"Van Wert County",39161,1076,176,1252,0.8594249201
No,Ohio,39,"Vinton County",39163,298,73,371,0.8032345013
No,Ohio,39,"Warren County",39165,3990,897,4887,0.8164518109
No,Ohio,39,"Washington County",39167,2029,364,2393,0.8478896782
No,Ohio,39,"Wayne County",39169,2919,468,3387,0.8618246236
No,Ohio,39,"Williams County",39171,1283,235,1518,0.8451910408
No,Ohio,39,"Wood County",39173,3231,622,3853,0.8385673501
No,Ohio,39,"Wyandot County",39175,779,140,919,0.8476605005
No,Ohio,39,,39999,104,16,120,0.8666666667
No,Oklahoma,40,"Adair County",40001,281,68,349,0.8051575931
No,Oklahoma,40,"Alfalfa County",40003,173,51,224,0.7723214286
No,Oklahoma,40,"Atoka County",40005,332,103,435,0.7632183908
No,Oklahoma,40,"Beaver County",40007,131,47,178,0.7359550562
No,Oklahoma,40,"Beckham County",40009,485,121,606,0.800330033
No,Oklahoma,40,"Blaine County",40011,309,76,385,0.8025974026
No,Oklahoma,40,"Bryan County",40013,1061,308,1369,0.7750182615
No,Oklahoma,40,"Caddo County",40015,605,158,763,0.7929226737
No,Oklahoma,40,"Canadian County",40017,2330,502,2832,0.822740113
No,Oklahoma,40,"Carter County",40019,1366,399,1765,0.7739376771
No,Oklahoma,40,"Cherokee County",40021,777,216,993,0.7824773414
No,Oklahoma,40,"Choctaw County",40023,361,141,502,0.719123506
No,Oklahoma,40,"Cimarron County",40025,69,26,95,0.7263157895
No,Oklahoma,40,"Cleveland County",40027,4762,1059,5821,0.8180724961
No,Oklahoma,40,"Coal County",40029,127,29,156,0.8141025641
No,Oklahoma,40,"Comanche County",40031,1355,353,1708,0.7933255269
No,Oklahoma,40,"Cotton County",40033,152,38,190,0.8
No,Oklahoma,40,"Craig County",40035,346,99,445,0.7775280899
No,Oklahoma,40,"Creek County",40037,1477,385,1862,0.7932330827
No,Oklahoma,40,"Custer County",40039,600,146,746,0.8042895442
No,Oklahoma,40,"Delaware County",40041,1230,336,1566,0.785440613
No,Oklahoma,40,"Dewey County",40043,163,41,204,0.7990196078
No,Oklahoma,40,"Ellis County",40045,148,42,190,0.7789473684
No,Oklahoma,40,"Garfield County",40047,1681,426,2107,0.7978168011
No,Oklahoma,40,"Garvin County",40049,763,194,957,0.7972831766
No,Oklahoma,40,"Grady County",40051,1254,266,1520,0.825
No,Oklahoma,40,"Grant County",40053,168,48,216,0.7777777778
No,Oklahoma,40,"Greer County",40055,142,25,167,0.8502994012
No,Oklahoma,40,"Harmon County",40057,89,29,118,0.7542372881
No,Oklahoma,40,"Harper County",40059,147,29,176,0.8352272727
No,Oklahoma,40,"Haskell County",40061,321,91,412,0.7791262136
No,Oklahoma,40,"Hughes County",40063,270,78,348,0.775862069
No,Oklahoma,40,"Jackson County",40065,393,92,485,0.8103092784
No,Oklahoma,40,"Jefferson County",40067,179,36,215,0.8325581395
No,Oklahoma,40,"Johnston County",40069,220,70,290,0.7586206897
No,Oklahoma,40,"Kay County",40071,1379,307,1686,0.8179122183
No,Oklahoma,40,"Kingfisher County",40073,440,110,550,0.8
No,Oklahoma,40,"Kiowa County",40075,246,69,315,0.780952381
No,Oklahoma,40,"Latimer County",40077,292,83,375,0.7786666667
No,Oklahoma,40,"Le Flore County",40079,1217,333,1550,0.7851612903
No,Oklahoma,40,"Lincoln County",40081,668,148,816,0.818627451
No,Oklahoma,40,"Logan County",40083,832,214,1046,0.7954110899
No,Oklahoma,40,"Love County",40085,320,83,403,0.794044665
No,Oklahoma,40,"McClain County",40087,900,240,1140,0.7894736842
No,Oklahoma,40,"McCurtain County",40089,750,278,1028,0.7295719844
No,Oklahoma,40,"McIntosh County",40091,547,143,690,0.7927536232
No,Oklahoma,40,"Major County",40093,283,65,348,0.8132183908
No,Oklahoma,40,"Marshall County",40095,463,131,594,0.7794612795
No,Oklahoma,40,"Mayes County",40097,1021,243,1264,0.8077531646
No,Oklahoma,40,"Murray County",40099,375,96,471,0.7961783439
No,Oklahoma,40,"Muskogee County",40101,1504,424,1928,0.7800829876
No,Oklahoma,40,"Noble County",40103,383,77,460,0.8326086957
No,Oklahoma,40,"Nowata County",40105,235,60,295,0.7966101695
No,Oklahoma,40,"Okfuskee County",40107,230,71,301,0.7641196013
No,Oklahoma,40,"Oklahoma County",40109,11241,2756,13997,0.8031006644
No,Oklahoma,40,"Okmulgee County",40111,822,262,1084,0.758302583
No,Oklahoma,40,"Osage County",40113,1066,287,1353,0.7878787879
No,Oklahoma,40,"Ottawa County",40115,781,205,986,0.7920892495
No,Oklahoma,40,"Pawnee County",40117,412,95,507,0.8126232742
No,Oklahoma,40,"Payne County",40119,1822,427,2249,0.810137839
No,Oklahoma,40,"Pittsburg County",40121,1056,294,1350,0.7822222222
No,Oklahoma,40,"Pontotoc County",40123,941,233,1174,0.8015332198
No,Oklahoma,40,"Pottawatomie County",40125,1310,306,1616,0.8106435644
No,Oklahoma,40,"Pushmataha County",40127,289,96,385,0.7506493506
No,Oklahoma,40,"Roger Mills County",40129,105,33,138,0.7608695652
No,Oklahoma,40,"Rogers County",40131,2169,521,2690,0.8063197026
No,Oklahoma,40,"Seminole County",40133,473,120,593,0.7976391231
No,Oklahoma,40,"Sequoyah County",40135,824,223,1047,0.7870105062
No,Oklahoma,40,"Stephens County",40137,1295,322,1617,0.8008658009
No,Oklahoma,40,"Texas County",40139,363,104,467,0.7773019272
No,Oklahoma,40,"Tillman County",40141,191,45,236,0.8093220339
No,Oklahoma,40,"Tulsa County",40143,11141,2700,13841,0.8049273896
No,Oklahoma,40,"Wagoner County",40145,1556,418,1974,0.7882472138
No,Oklahoma,40,"Washington County",40147,1793,345,2138,0.8386342376
No,Oklahoma,40,"Washita County",40149,289,72,361,0.8005540166
No,Oklahoma,40,"Woods County",40151,333,81,414,0.8043478261
No,Oklahoma,40,"Woodward County",40153,583,138,721,0.8085991678
No,Oklahoma,40,,40999,48,12,60,0.8
No,Oregon,41,"Baker County",41001,424,85,509,0.8330058939
No,Oregon,41,"Benton County",41003,1128,208,1336,0.8443113772
No,Oregon,41,"Clackamas County",41005,3962,798,4760,0.8323529412
No,Oregon,41,"Clatsop County",41007,1003,213,1216,0.8248355263
No,Oregon,41,"Columbia County",41009,708,141,849,0.8339222615
No,Oregon,41,"Coos County",41011,2133,507,2640,0.8079545455
No,Oregon,41,"Crook County",41013,566,106,672,0.8422619048
No,Oregon,41,"Curry County",41015,863,223,1086,0.7946593002
No,Oregon,41,"Deschutes County",41017,3339,749,4088,0.8167808219
No,Oregon,41,"Douglas County",41019,2859,686,3545,0.8064880113
No,Oregon,41,"Gilliam County",41021,44,13,57,0.7719298246
No,Oregon,41,"Grant County",41023,153,27,180,0.85
No,Oregon,41,"Harney County",41025,174,28,202,0.8613861386
No,Oregon,41,"Hood River County",41027,314,46,360,0.8722222222
No,Oregon,41,"Jackson County",41029,4452,964,5416,0.8220088626
No,Oregon,41,"Jefferson County",41031,356,70,426,0.8356807512
No,Oregon,41,"Josephine County",41033,2033,455,2488,0.8171221865
No,Oregon,41,"Klamath County",41035,1420,264,1684,0.8432304038
No,Oregon,41,"Lake County",41037,208,46,254,0.8188976378
No,Oregon,41,"Lane County",41039,5486,1212,6698,0.8190504628
No,Oregon,41,"Lincoln County",41041,1622,315,1937,0.8373773877
No,Oregon,41,"Linn County",41043,1933,387,2320,0.8331896552
No,Oregon,41,"Malheur County",41045,647,144,791,0.8179519595
No,Oregon,41,"Marion County",41047,3153,647,3800,0.8297368421
No,Oregon,41,"Morrow County",41049,232,56,288,0.8055555556
No,Oregon,41,"Multnomah County",41051,4593,991,5584,0.8225286533
No,Oregon,41,"Polk County",41053,924,201,1125,0.8213333333
No,Oregon,41,"Sherman County",41055,.,.,.,0.9333333333
No,Oregon,41,"Tillamook County",41057,720,185,905,0.7955801105
No,Oregon,41,"Umatilla County",41059,1538,337,1875,0.8202666667
No,Oregon,41,"Union County",41061,697,138,835,0.8347305389
No,Oregon,41,"Wallowa County",41063,257,44,301,0.853820598
No,Oregon,41,"Wasco County",41065,573,120,693,0.8268398268
No,Oregon,41,"Washington County",41067,4165,810,4975,0.8371859296
No,Oregon,41,"Wheeler County",41069,.,.,.,0.8333333333
No,Oregon,41,"Yamhill County",41071,1282,256,1538,0.833550065
No,Oregon,41,,41999,.,.,.,0.8461538462
No,Pennsylvania,42,"Adams County",42001,2866,531,3397,0.8436856049
No,Pennsylvania,42,"Allegheny County",42003,13622,2687,16309,0.8352443436
No,Pennsylvania,42,"Armstrong County",42005,900,171,1071,0.8403361345
No,Pennsylvania,42,"Beaver County",42007,2336,461,2797,0.8351805506
No,Pennsylvania,42,"Bedford County",42009,1024,187,1211,0.8455821635
No,Pennsylvania,42,"Berks County",42011,10832,1689,12521,0.8651066209
No,Pennsylvania,42,"Blair County",42013,2260,430,2690,0.8401486989
No,Pennsylvania,42,"Bradford County",42015,1827,352,2179,0.8384580083
No,Pennsylvania,42,"Bucks County",42017,16399,2721,19120,0.8576882845
No,Pennsylvania,42,"Butler County",42019,2943,559,3502,0.8403769275
No,Pennsylvania,42,"Cambria County",42021,1843,352,2195,0.8396355353
No,Pennsylvania,42,"Cameron County",42023,194,35,229,0.8471615721
No,Pennsylvania,42,"Carbon County",42025,2073,411,2484,0.8345410628
No,Pennsylvania,42,"Centre County",42027,2163,349,2512,0.861066879
No,Pennsylvania,42,"Chester County",42029,12298,2140,14438,0.8517800249
No,Pennsylvania,42,"Clarion County",42031,955,162,1117,0.8549686661
No,Pennsylvania,42,"Clearfield County",42033,1925,322,2247,0.8566978193
No,Pennsylvania,42,"Clinton County",42035,953,134,1087,0.876724931
No,Pennsylvania,42,"Columbia County",42037,1527,229,1756,0.8695899772
No,Pennsylvania,42,"Crawford County",42039,2382,459,2841,0.83843717
No,Pennsylvania,42,"Cumberland County",42041,4848,798,5646,0.8586609989
No,Pennsylvania,42,"Dauphin County",42043,3723,725,4448,0.8370053957
No,Pennsylvania,42,"Delaware County",42045,11389,2124,13513,0.8428180271
No,Pennsylvania,42,"Elk County",42047,1285,210,1495,0.8595317726
No,Pennsylvania,42,"Erie County",42049,5084,900,5984,0.8495989305
No,Pennsylvania,42,"Fayette County",42051,2455,521,2976,0.8249327957
No,Pennsylvania,42,"Forest County",42053,164,23,187,0.8770053476
No,Pennsylvania,42,"Franklin County",42055,4217,669,4886,0.8630781826
No,Pennsylvania,42,"Fulton County",42057,417,77,494,0.8441295547
No,Pennsylvania,42,"Greene County",42059,585,94,679,0.8615611193
No,Pennsylvania,42,"Huntingdon County",42061,1150,194,1344,0.8556547619
No,Pennsylvania,42,"Indiana County",42063,1087,206,1293,0.8406805878
No,Pennsylvania,42,"Jefferson County",42065,1106,185,1291,0.8567002324
No,Pennsylvania,42,"Juniata County",42067,555,103,658,0.8434650456
No,Pennsylvania,42,"Lackawanna County",42069,5690,986,6676,0.8523067705
No,Pennsylvania,42,"Lancaster County",42071,12975,2055,15030,0.8632734531
No,Pennsylvania,42,"Lawrence County",42073,1511,293,1804,0.8375831486
No,Pennsylvania,42,"Lebanon County",42075,3364,564,3928,0.8564154786
No,Pennsylvania,42,"Lehigh County",42077,8535,1398,9933,0.859257022
No,Pennsylvania,42,"Luzerne County",42079,8928,1682,10610,0.841470311
No,Pennsylvania,42,"Lycoming County",42081,3183,560,3743,0.8503873898
No,Pennsylvania,42,"Mc Kean County",42083,1268,235,1503,0.8436460413
No,Pennsylvania,42,"Mercer County",42085,2507,447,2954,0.8486797563
No,Pennsylvania,42,"Mifflin County",42087,1250,211,1461,0.855578371
No,Pennsylvania,42,"Monroe County",42089,4025,779,4804,0.8378434638
No,Pennsylvania,42,"Montgomery County",42091,19656,3559,23215,0.8466939479
No,Pennsylvania,42,"Montour County",42093,386,62,448,0.8616071429
No,Pennsylvania,42,"Northampton County",42095,9602,1578,11180,0.8588550984
No,Pennsylvania,42,"Northumberland County",42097,2585,451,3036,0.8514492754
No,Pennsylvania,42,"Perry County",42099,910,162,1072,0.848880597
No,Pennsylvania,42,"Philadelphia County",42101,13880,3347,17227,0.8057119638
No,Pennsylvania,42,"Pike County",42103,2182,408,2590,0.8424710425
No,Pennsylvania,42,"Potter County",42105,508,98,606,0.8382838284
No,Pennsylvania,42,"Schuylkill County",42107,4244,824,5068,0.8374112076
No,Pennsylvania,42,"Snyder County",42109,1001,154,1155,0.8666666667
No,Pennsylvania,42,"Somerset County",42111,1401,260,1661,0.8434677905
No,Pennsylvania,42,"Sullivan County",42113,204,42,246,0.8292682927
No,Pennsylvania,42,"Susquehanna County",42115,1456,268,1724,0.8445475638
No,Pennsylvania,42,"Tioga County",42117,1259,235,1494,0.8427041499
No,Pennsylvania,42,"Union County",42119,1013,176,1189,0.8519764508
No,Pennsylvania,42,"Venango County",42121,1232,254,1486,0.8290713324
No,Pennsylvania,42,"Warren County",42123,1357,246,1603,0.8465377417
No,Pennsylvania,42,"Washington County",42125,2825,538,3363,0.8400237883
No,Pennsylvania,42,"Wayne County",42127,2037,349,2386,0.8537300922
No,Pennsylvania,42,"Westmoreland County",42129,5403,961,6364,0.8489943432
No,Pennsylvania,42,"Wyoming County",42131,768,122,890,0.8629213483
No,Pennsylvania,42,"York County",42133,10383,1742,12125,0.8563298969
No,Pennsylvania,42,,42999,88,17,105,0.8380952381
No,"Rhode Island",44,"Bristol County",44001,998,148,1146,0.8708551483
No,"Rhode Island",44,"Kent County",44003,3446,629,4075,0.8456441718
No,"Rhode Island",44,"Newport County",44005,1943,355,2298,0.8455178416
No,"Rhode Island",44,"Providence County",44007,8769,1589,10358,0.8465920062
No,"Rhode Island",44,"Washington County",44009,3430,553,3983,0.8611599297
No,"Rhode Island",44,,44999,.,0,.,1
No,"South Carolina",45,"Abbeville County",45001,598,146,744,0.8037634409
No,"South Carolina",45,"Aiken County",45003,4117,969,5086,0.8094769957
No,"South Carolina",45,"Allendale County",45005,133,56,189,0.7037037037
No,"South Carolina",45,"Anderson County",45007,4538,1030,5568,0.8150143678
No,"South Carolina",45,"Bamberg County",45009,301,79,380,0.7921052632
No,"South Carolina",45,"Barnwell County",45011,451,130,581,0.7762478485
No,"South Carolina",45,"Beaufort County",45013,6000,1279,7279,0.8242890507
No,"South Carolina",45,"Berkeley County",45015,2772,640,3412,0.8124267292
No,"South Carolina",45,"Calhoun County",45017,320,108,428,0.7476635514
No,"South Carolina",45,"Charleston County",45019,6095,1389,7484,0.814404062
No,"South Carolina",45,"Cherokee County",45021,1243,305,1548,0.8029715762
No,"South Carolina",45,"Chester County",45023,750,222,972,0.7716049383
No,"South Carolina",45,"Chesterfield County",45025,1046,282,1328,0.7876506024
No,"South Carolina",45,"Clarendon County",45027,799,241,1040,0.7682692308
No,"South Carolina",45,"Colleton County",45029,748,228,976,0.7663934426
No,"South Carolina",45,"Darlington County",45031,1767,459,2226,0.7938005391
No,"South Carolina",45,"Dillon County",45033,636,194,830,0.7662650602
No,"South Carolina",45,"Dorchester County",45035,2252,596,2848,0.7907303371
No,"South Carolina",45,"Edgefield County",45037,560,135,695,0.8057553957
No,"South Carolina",45,"Fairfield County",45039,480,136,616,0.7792207792
No,"South Carolina",45,"Florence County",45041,3532,994,4526,0.7803800265
No,"South Carolina",45,"Georgetown County",45043,2555,591,3146,0.8121424031
No,"South Carolina",45,"Greenville County",45045,10113,2227,12340,0.8195299838
No,"South Carolina",45,"Greenwood County",45047,1785,466,2251,0.7929808974
No,"South Carolina",45,"Hampton County",45049,372,124,496,0.75
No,"South Carolina",45,"Horry County",45051,12785,2683,15468,0.8265451254
No,"South Carolina",45,"Jasper County",45053,675,168,843,0.8007117438
No,"South Carolina",45,"Kershaw County",45055,1649,395,2044,0.8067514677
No,"South Carolina",45,"Lancaster County",45057,2882,688,3570,0.8072829132
No,"South Carolina",45,"Laurens County",45059,1691,402,2093,0.8079311992
No,"South Carolina",45,"Lee County",45061,422,110,532,0.7932330827
No,"South Carolina",45,"Lexington County",45063,6426,1458,7884,0.8150684932
No,"South Carolina",45,"McCormick County",45065,358,84,442,0.8099547511
No,"South Carolina",45,"Marion County",45067,736,222,958,0.7682672234
No,"South Carolina",45,"Marlboro County",45069,584,171,755,0.7735099338
No,"South Carolina",45,"Newberry County",45071,1054,256,1310,0.8045801527
No,"South Carolina",45,"Oconee County",45073,2388,528,2916,0.8189300412
No,"South Carolina",45,"Orangeburg County",45075,1697,462,2159,0.7860120426
No,"South Carolina",45,"Pickens County",45077,2545,610,3155,0.8066561014
No,"South Carolina",45,"Richland County",45079,5917,1531,7448,0.7944414608
No,"South Carolina",45,"Saluda County",45081,523,124,647,0.8083462133
No,"South Carolina",45,"Spartanburg County",45083,6624,1609,8233,0.8045669865
No,"South Carolina",45,"Sumter County",45085,1772,508,2280,0.7771929825
No,"South Carolina",45,"Union County",45087,720,149,869,0.8285385501
No,"South Carolina",45,"Williamsburg County",45089,699,235,934,0.7483940043
No,"South Carolina",45,"York County",45091,5461,1204,6665,0.8193548387
No,"South Carolina",45,,45999,52,12,64,0.8125
No,"South Dakota",46,"Aurora County",46003,115,13,128,0.8984375
No,"South Dakota",46,"Beadle County",46005,636,129,765,0.831372549
No,"South Dakota",46,"Bennett County",46007,.,.,.,0.8793103448
No,"South Dakota",46,"Bon Homme County",46009,255,26,281,0.9074733096
No,"South Dakota",46,"Brookings County",46011,766,110,876,0.8744292237
No,"South Dakota",46,"Brown County",46013,1475,204,1679,0.8784991066
No,"South Dakota",46,"Brule County",46015,148,18,166,0.8915662651
No,"South Dakota",46,"Buffalo County",46017,.,.,.,0.6666666667
No,"South Dakota",46,"Butte County",46019,276,35,311,0.8874598071
No,"South Dakota",46,"Campbell County",46021,.,.,.,0.8913043478
No,"South Dakota",46,"Charles Mix County",46023,293,45,338,0.8668639053
No,"South Dakota",46,"Clark County",46025,126,13,139,0.9064748201
No,"South Dakota",46,"Clay County",46027,361,49,410,0.8804878049
No,"South Dakota",46,"Codington County",46029,777,113,890,0.8730337079
No,"South Dakota",46,"Corson County",46031,.,.,.,0.8
No,"South Dakota",46,"Custer County",46033,283,51,334,0.8473053892
No,"South Dakota",46,"Davison County",46035,766,99,865,0.8855491329
No,"South Dakota",46,"Day County",46037,254,47,301,0.8438538206
No,"South Dakota",46,"Deuel County",46039,149,16,165,0.903030303
No,"South Dakota",46,"Dewey County",46041,59,11,70,0.8428571429
No,"South Dakota",46,"Douglas County",46043,145,28,173,0.838150289
No,"South Dakota",46,"Edmunds County",46045,206,28,234,0.8803418803
No,"South Dakota",46,"Fall River County",46047,174,37,211,0.8246445498
No,"South Dakota",46,"Faulk County",46049,120,17,137,0.8759124088
No,"South Dakota",46,"Grant County",46051,285,38,323,0.8823529412
No,"South Dakota",46,"Gregory County",46053,178,33,211,0.8436018957
No,"South Dakota",46,"Haakon County",46055,113,17,130,0.8692307692
No,"South Dakota",46,"Hamlin County",46057,168,19,187,0.8983957219
No,"South Dakota",46,"Hand County",46059,187,21,208,0.8990384615
No,"South Dakota",46,"Hanson County",46061,189,36,225,0.84
No,"South Dakota",46,"Harding County",46063,.,.,.,0.9047619048
No,"South Dakota",46,"Hughes County",46065,501,65,566,0.8851590106
No,"South Dakota",46,"Hutchinson County",46067,367,59,426,0.8615023474
No,"South Dakota",46,"Hyde County",46069,60,11,71,0.8450704225
No,"South Dakota",46,"Jackson County",46071,.,.,.,0.921875
No,"South Dakota",46,"Jerauld County",46073,.,.,.,0.8936170213
No,"South Dakota",46,"Jones County",46075,.,.,.,0.8974358974
No,"South Dakota",46,"Kingsbury County",46077,243,38,281,0.8647686833
No,"South Dakota",46,"Lake County",46079,381,54,435,0.875862069
No,"South Dakota",46,"Lawrence County",46081,709,124,833,0.8511404562
No,"South Dakota",46,"Lincoln County",46083,1329,169,1498,0.8871829105
No,"South Dakota",46,"Lyman County",46085,83,12,95,0.8736842105
No,"South Dakota",46,"McCook County",46087,200,19,219,0.9132420091
No,"South Dakota",46,"McPherson County",46089,159,24,183,0.868852459
No,"South Dakota",46,"Marshall County",46091,162,28,190,0.8526315789
No,"South Dakota",46,"Meade County",46093,484,79,563,0.8596802842
No,"South Dakota",46,"Mellette County",46095,.,.,.,0.8787878788
No,"South Dakota",46,"Miner County",46097,87,17,104,0.8365384615
No,"South Dakota",46,"Minnehaha County",46099,4623,749,5372,0.8605733433
No,"South Dakota",46,"Moody County",46101,208,26,234,0.8888888889
No,"South Dakota",46,,46102,15,18,33,0.4545454545
No,"South Dakota",46,"Pennington County",46103,2630,500,3130,0.8402555911
No,"South Dakota",46,"Perkins County",46105,117,25,142,0.823943662
No,"South Dakota",46,"Potter County",46107,120,20,140,0.8571428571
No,"South Dakota",46,"Roberts County",46109,322,41,363,0.8870523416
No,"South Dakota",46,"Sanborn County",46111,88,12,100,0.88
No,"South Dakota",46,"Spink County",46115,348,40,388,0.8969072165
No,"South Dakota",46,"Stanley County",46117,113,16,129,0.8759689922
No,"South Dakota",46,"Sully County",46119,57,11,68,0.8382352941
No,"South Dakota",46,"Todd County",46121,20,12,32,0.625
No,"South Dakota",46,"Tripp County",46123,225,32,257,0.8754863813
No,"South Dakota",46,"Turner County",46125,317,52,369,0.8590785908
No,"South Dakota",46,"Union County",46127,552,76,628,0.8789808917
No,"South Dakota",46,"Walworth County",46129,225,36,261,0.8620689655
No,"South Dakota",46,"Yankton County",46135,727,103,830,0.8759036145
No,"South Dakota",46,"Ziebach County",46137,.,.,.,0.8823529412
No,"South Dakota",46,,46999,.,.,.,0.84
No,Tennessee,47,"Anderson County",47001,1584,355,1939,0.816915936
No,Tennessee,47,"Bedford County",47003,878,170,1048,0.8377862595
No,Tennessee,47,"Benton County",47005,548,132,680,0.8058823529
No,Tennessee,47,"Bledsoe County",47007,301,80,381,0.7900262467
No,Tennessee,47,"Blount County",47009,2602,563,3165,0.8221169036
No,Tennessee,47,"Bradley County",47011,2200,448,2648,0.83081571
No,Tennessee,47,"Campbell County",47013,646,162,808,0.7995049505
No,Tennessee,47,"Cannon County",47015,296,81,377,0.7851458886
No,Tennessee,47,"Carroll County",47017,1017,207,1224,0.8308823529
No,Tennessee,47,"Carter County",47019,935,218,1153,0.8109280139
No,Tennessee,47,"Cheatham County",47021,616,128,744,0.8279569892
No,Tennessee,47,"Chester County",47023,403,87,490,0.8224489796
No,Tennessee,47,"Claiborne County",47025,617,153,770,0.8012987013
No,Tennessee,47,"Clay County",47027,249,43,292,0.852739726
No,Tennessee,47,"Cocke County",47029,745,174,919,0.810663765
No,Tennessee,47,"Coffee County",47031,1356,335,1691,0.8018923714
No,Tennessee,47,"Crockett County",47033,401,101,502,0.7988047809
No,Tennessee,47,"Cumberland County",47035,3118,651,3769,0.8272751393
No,Tennessee,47,"Davidson County",47037,7422,1691,9113,0.8144409086
No,Tennessee,47,"Decatur County",47039,360,75,435,0.8275862069
No,Tennessee,47,"DeKalb County",47041,423,92,515,0.8213592233
No,Tennessee,47,"Dickson County",47043,954,215,1169,0.8160821215
No,Tennessee,47,"Dyer County",47045,1039,269,1308,0.7943425076
No,Tennessee,47,"Fayette County",47047,1216,308,1524,0.7979002625
No,Tennessee,47,"Fentress County",47049,575,114,689,0.8345428157
No,Tennessee,47,"Franklin County",47051,1124,270,1394,0.806312769
No,Tennessee,47,"Gibson County",47053,1388,341,1729,0.8027761712
No,Tennessee,47,"Giles County",47055,926,199,1125,0.8231111111
No,Tennessee,47,"Grainger County",47057,411,111,522,0.7873563218
No,Tennessee,47,"Greene County",47059,1583,298,1881,0.841573631
No,Tennessee,47,"Grundy County",47061,330,69,399,0.8270676692
No,Tennessee,47,"Hamblen County",47063,1394,292,1686,0.8268090154
No,Tennessee,47,"Hamilton County",47065,7244,1630,8874,0.8163173315
No,Tennessee,47,"Hancock County",47067,125,25,150,0.8333333333
No,Tennessee,47,"Hardeman County",47069,612,166,778,0.7866323907
No,Tennessee,47,"Hardin County",47071,787,202,989,0.7957532861
No,Tennessee,47,"Hawkins County",47073,1044,222,1266,0.8246445498
No,Tennessee,47,"Haywood County",47075,368,111,479,0.7682672234
No,Tennessee,47,"Henderson County",47077,721,165,886,0.8137697517
No,Tennessee,47,"Henry County",47079,1152,239,1391,0.8281811646
No,Tennessee,47,"Hickman County",47081,433,97,530,0.8169811321
No,Tennessee,47,"Houston County",47083,195,50,245,0.7959183673
No,Tennessee,47,"Humphreys County",47085,569,127,696,0.8175287356
No,Tennessee,47,"Jackson County",47087,377,66,443,0.8510158014
No,Tennessee,47,"Jefferson County",47089,1120,242,1362,0.8223201175
No,Tennessee,47,"Johnson County",47091,359,70,429,0.8368298368
No,Tennessee,47,"Knox County",47093,7280,1595,8875,0.8202816901
No,Tennessee,47,"Lake County",47095,159,39,198,0.803030303
No,Tennessee,47,"Lauderdale County",47097,544,163,707,0.7694483734
No,Tennessee,47,"Lawrence County",47099,1249,264,1513,0.8255122274
No,Tennessee,47,"Lewis County",47101,266,61,327,0.8134556575
No,Tennessee,47,"Lincoln County",47103,851,160,1011,0.8417408506
No,Tennessee,47,"Loudon County",47105,1657,362,2019,0.8207033185
No,Tennessee,47,"McMinn County",47107,1317,311,1628,0.808968059
No,Tennessee,47,"McNairy County",47109,795,197,992,0.8014112903
No,Tennessee,47,"Macon County",47111,586,138,724,0.8093922652
No,Tennessee,47,"Madison County",47113,2372,644,3016,0.7864721485
No,Tennessee,47,"Marion County",47115,689,150,839,0.821215733
No,Tennessee,47,"Marshall County",47117,700,139,839,0.8343265793
No,Tennessee,47,"Maury County",47119,2233,454,2687,0.8310383327
No,Tennessee,47,"Meigs County",47121,286,77,363,0.7878787879
No,Tennessee,47,"Monroe County",47123,1019,233,1252,0.8138977636
No,Tennessee,47,"Montgomery County",47125,1933,386,2319,0.8335489435
No,Tennessee,47,"Moore County",47127,199,45,244,0.8155737705
No,Tennessee,47,"Morgan County",47129,370,98,468,0.7905982906
No,Tennessee,47,"Obion County",47131,1257,262,1519,0.827518104
No,Tennessee,47,"Overton County",47133,650,139,789,0.8238276299
No,Tennessee,47,"Perry County",47135,195,42,237,0.8227848101
No,Tennessee,47,"Pickett County",47137,194,56,250,0.776
No,Tennessee,47,"Polk County",47139,509,112,621,0.8196457327
No,Tennessee,47,"Putnam County",47141,1967,429,2396,0.820951586
No,Tennessee,47,"Rhea County",47143,864,197,1061,0.8143261074
No,Tennessee,47,"Roane County",47145,1387,296,1683,0.8241235888
No,Tennessee,47,"Robertson County",47147,1266,263,1529,0.8279921517
No,Tennessee,47,"Rutherford County",47149,3774,833,4607,0.8191881919
No,Tennessee,47,"Scott County",47151,409,88,497,0.8229376258
No,Tennessee,47,"Sequatchie County",47153,370,98,468,0.7905982906
No,Tennessee,47,"Sevier County",47155,1977,418,2395,0.8254697286
No,Tennessee,47,"Shelby County",47157,14012,3821,17833,0.7857343128
No,Tennessee,47,"Smith County",47159,441,110,551,0.8003629764
No,Tennessee,47,"Stewart County",47161,338,82,420,0.8047619048
No,Tennessee,47,"Sullivan County",47163,2998,572,3570,0.8397759104
No,Tennessee,47,"Sumner County",47165,3537,805,4342,0.8146015661
No,Tennessee,47,"Tipton County",47167,1233,343,1576,0.7823604061
No,Tennessee,47,"Trousdale County",47169,190,35,225,0.8444444444
No,Tennessee,47,"Unicoi County",47171,371,79,450,0.8244444444
No,Tennessee,47,"Union County",47173,267,72,339,0.7876106195
No,Tennessee,47,"Van Buren County",47175,182,52,234,0.7777777778
No,Tennessee,47,"Warren County",47177,1046,231,1277,0.8191072827
No,Tennessee,47,"Washington County",47179,2237,476,2713,0.8245484703
No,Tennessee,47,"Wayne County",47181,438,88,526,0.8326996198
No,Tennessee,47,"Weakley County",47183,1122,177,1299,0.8637413395
No,Tennessee,47,"White County",47185,841,184,1025,0.8204878049
No,Tennessee,47,"Williamson County",47187,3692,699,4391,0.8408107493
No,Tennessee,47,"Wilson County",47189,2762,585,3347,0.8252166119
No,Tennessee,47,,47999,50,11,61,0.8196721311
No,Texas,48,"Anderson County",48001,1167,297,1464,0.7971311475
No,Texas,48,"Andrews County",48003,241,76,317,0.7602523659
No,Texas,48,"Angelina County",48005,2279,560,2839,0.8027474463
No,Texas,48,"Aransas County",48007,633,131,764,0.8285340314
No,Texas,48,"Archer County",48009,277,56,333,0.8318318318
No,Texas,48,"Armstrong County",48011,63,15,78,0.8076923077
No,Texas,48,"Atascosa County",48013,553,144,697,0.7934002869
No,Texas,48,"Austin County",48015,849,227,1076,0.7890334572
No,Texas,48,"Bailey County",48017,125,33,158,0.7911392405
No,Texas,48,"Bandera County",48019,574,147,721,0.7961165049
No,Texas,48,"Bastrop County",48021,1221,310,1531,0.7975179621
No,Texas,48,"Baylor County",48023,129,35,164,0.7865853659
No,Texas,48,"Bee County",48025,288,100,388,0.7422680412
No,Texas,48,"Bell County",48027,2250,571,2821,0.7975895073
No,Texas,48,"Bexar County",48029,14106,3617,17723,0.7959149128
No,Texas,48,"Blanco County",48031,373,67,440,0.8477272727
No,Texas,48,"Borden County",48033,.,.,.,0.7631578947
No,Texas,48,"Bosque County",48035,501,129,630,0.7952380952
No,Texas,48,"Bowie County",48037,1622,434,2056,0.7889105058
No,Texas,48,"Brazoria County",48039,5594,1463,7057,0.7926881111
No,Texas,48,"Brazos County",48041,2805,625,3430,0.8177842566
No,Texas,48,"Brewster County",48043,155,52,207,0.7487922705
No,Texas,48,"Briscoe County",48045,50,11,61,0.8196721311
No,Texas,48,"Brooks County",48047,104,39,143,0.7272727273
No,Texas,48,"Brown County",48049,1122,282,1404,0.7991452991
No,Texas,48,"Burleson County",48051,478,125,603,0.7927031509
No,Texas,48,"Burnet County",48053,1398,323,1721,0.8123184195
No,Texas,48,"Caldwell County",48055,557,162,719,0.7746870654
No,Texas,48,"Calhoun County",48057,472,119,591,0.7986463621
No,Texas,48,"Callahan County",48059,377,83,460,0.8195652174
No,Texas,48,"Cameron County",48061,3074,824,3898,0.7886095434
No,Texas,48,"Camp County",48063,287,55,342,0.8391812865
No,Texas,48,"Carson County",48065,181,39,220,0.8227272727
No,Texas,48,"Cass County",48067,855,230,1085,0.7880184332
No,Texas,48,"Castro County",48069,154,42,196,0.7857142857
No,Texas,48,"Chambers County",48071,711,199,910,0.7813186813
No,Texas,48,"Cherokee County",48073,1234,357,1591,0.7756128221
No,Texas,48,"Childress County",48075,151,39,190,0.7947368421
No,Texas,48,"Clay County",48077,326,74,400,0.815
No,Texas,48,"Cochran County",48079,50,11,61,0.8196721311
No,Texas,48,"Coke County",48081,124,36,160,0.775
No,Texas,48,"Coleman County",48083,283,58,341,0.8299120235
No,Texas,48,"Collin County",48085,13232,3075,16307,0.8114306739
No,Texas,48,"Collingsworth County",48087,86,30,116,0.7413793103
No,Texas,48,"Colorado County",48089,806,188,994,0.8108651911
No,Texas,48,"Comal County",48091,3263,699,3962,0.8235739525
No,Texas,48,"Comanche County",48093,412,115,527,0.7817836812
No,Texas,48,"Concho County",48095,94,12,106,0.8867924528
No,Texas,48,"Cooke County",48097,1142,292,1434,0.7963737796
No,Texas,48,"Coryell County",48099,449,115,564,0.7960992908
No,Texas,48,"Cottle County",48101,38,17,55,0.6909090909
No,Texas,48,"Crane County",48103,79,22,101,0.7821782178
No,Texas,48,"Crockett County",48105,96,18,114,0.8421052632
No,Texas,48,"Crosby County",48107,128,40,168,0.7619047619
No,Texas,48,"Culberson County",48109,41,12,53,0.7735849057
No,Texas,48,"Dallam County",48111,109,27,136,0.8014705882
No,Texas,48,"Dallas County",48113,24730,6908,31638,0.7816549719
No,Texas,48,"Dawson County",48115,274,71,345,0.7942028986
No,Texas,48,"Deaf Smith County",48117,288,73,361,0.7977839335
No,Texas,48,"Delta County",48119,186,42,228,0.8157894737
No,Texas,48,"Denton County",48121,10813,2609,13422,0.8056176427
No,Texas,48,"DeWitt County",48123,572,154,726,0.7878787879
No,Texas,48,"Dickens County",48125,70,15,85,0.8235294118
No,Texas,48,"Dimmit County",48127,97,38,135,0.7185185185
No,Texas,48,"Donley County",48129,124,36,160,0.775
No,Texas,48,"Duval County",48131,143,35,178,0.8033707865
No,Texas,48,"Eastland County",48133,494,138,632,0.7816455696
No,Texas,48,"Ector County",48135,1776,571,2347,0.7567106945
No,Texas,48,"Edwards County",48137,54,16,70,0.7714285714
No,Texas,48,"Ellis County",48139,2968,728,3696,0.803030303
No,Texas,48,"El Paso County",48141,4514,1280,5794,0.7790818088
No,Texas,48,"Erath County",48143,820,160,980,0.8367346939
No,Texas,48,"Falls County",48145,212,57,269,0.7881040892
No,Texas,48,"Fannin County",48147,936,202,1138,0.8224956063
No,Texas,48,"Fayette County",48149,1007,240,1247,0.8075380914
No,Texas,48,"Fisher County",48151,135,31,166,0.813253012
No,Texas,48,"Floyd County",48153,160,40,200,0.8
No,Texas,48,"Foard County",48155,.,.,.,0.8431372549
No,Texas,48,"Fort Bend County",48157,8859,2327,11186,0.791972108
No,Texas,48,"Franklin County",48159,324,65,389,0.8329048843
No,Texas,48,"Freestone County",48161,569,157,726,0.7837465565
No,Texas,48,"Frio County",48163,179,64,243,0.7366255144
No,Texas,48,"Gaines County",48165,217,63,280,0.775
No,Texas,48,"Galveston County",48167,6151,1709,7860,0.7825699746
No,Texas,48,"Garza County",48169,83,31,114,0.7280701754
No,Texas,48,"Gillespie County",48171,1038,237,1275,0.8141176471
No,Texas,48,"Glasscock County",48173,.,.,.,0.78125
No,Texas,48,"Goliad County",48175,201,47,248,0.810483871
No,Texas,48,"Gonzales County",48177,469,144,613,0.7650897227
No,Texas,48,"Gray County",48179,665,150,815,0.8159509202
No,Texas,48,"Grayson County",48181,3595,973,4568,0.7869964974
No,Texas,48,"Gregg County",48183,2978,710,3688,0.807483731
No,Texas,48,"Grimes County",48185,612,194,806,0.7593052109
No,Texas,48,"Guadalupe County",48187,2155,440,2595,0.8304431599
No,Texas,48,"Hale County",48189,587,156,743,0.7900403769
No,Texas,48,"Hall County",48191,121,25,146,0.8287671233
No,Texas,48,"Hamilton County",48193,237,73,310,0.764516129
No,Texas,48,"Hansford County",48195,147,35,182,0.8076923077
No,Texas,48,"Hardeman County",48197,147,24,171,0.8596491228
No,Texas,48,"Hardin County",48199,1326,318,1644,0.8065693431
No,Texas,48,"Harris County",48201,42540,11671,54211,0.7847115899
No,Texas,48,"Harrison County",48203,1480,383,1863,0.794417606
No,Texas,48,"Hartley County",48205,99,24,123,0.8048780488
No,Texas,48,"Haskell County",48207,196,48,244,0.8032786885
No,Texas,48,"Hays County",48209,2584,591,3175,0.8138582677
No,Texas,48,"Hemphill County",48211,110,26,136,0.8088235294
No,Texas,48,"Henderson County",48213,2299,586,2885,0.7968804159
No,Texas,48,"Hidalgo County",48215,5229,1431,6660,0.7851351351
No,Texas,48,"Hill County",48217,881,238,1119,0.7873100983
No,Texas,48,"Hockley County",48219,463,128,591,0.7834179357
No,Texas,48,"Hood County",48221,2172,509,2681,0.8101454681
No,Texas,48,"Hopkins County",48223,1075,288,1363,0.788701394
No,Texas,48,"Houston County",48225,658,155,813,0.8093480935
No,Texas,48,"Howard County",48227,541,139,680,0.7955882353
No,Texas,48,"Hudspeth County",48229,32,19,51,0.6274509804
No,Texas,48,"Hunt County",48231,1875,559,2434,0.770336894
No,Texas,48,"Hutchinson County",48233,613,182,795,0.7710691824
No,Texas,48,"Irion County",48235,32,18,50,0.64
No,Texas,48,"Jack County",48237,256,59,315,0.8126984127
No,Texas,48,"Jackson County",48239,374,85,459,0.8148148148
No,Texas,48,"Jasper County",48241,1002,313,1315,0.7619771863
No,Texas,48,"Jeff Davis County",48243,57,20,77,0.7402597403
No,Texas,48,"Jefferson County",48245,4501,1153,5654,0.7960735762
No,Texas,48,"Jim Hogg County",48247,62,20,82,0.756097561
No,Texas,48,"Jim Wells County",48249,475,162,637,0.7456828885
No,Texas,48,"Johnson County",48251,2843,736,3579,0.7943559654
No,Texas,48,"Jones County",48253,405,111,516,0.7848837209
No,Texas,48,"Karnes County",48255,309,86,395,0.782278481
No,Texas,48,"Kaufman County",48257,2007,536,2543,0.7892253244
No,Texas,48,"Kendall County",48259,1051,248,1299,0.8090839107
No,Texas,48,"Kenedy County",48261,.,.,.,0.5
No,Texas,48,"Kent County",48263,24,11,35,0.6857142857
No,Texas,48,"Kerr County",48265,1734,364,2098,0.8265014299
No,Texas,48,"Kimble County",48267,149,37,186,0.8010752688
No,Texas,48,"King County",48269,.,.,.,0.5714285714
No,Texas,48,"Kinney County",48271,67,19,86,0.7790697674
No,Texas,48,"Kleberg County",48273,242,76,318,0.7610062893
No,Texas,48,"Knox County",48275,129,35,164,0.7865853659
No,Texas,48,"Lamar County",48277,1525,379,1904,0.8009453782
No,Texas,48,"Lamb County",48279,269,62,331,0.8126888218
No,Texas,48,"Lampasas County",48281,369,98,467,0.7901498929
No,Texas,48,"La Salle County",48283,77,30,107,0.7196261682
No,Texas,48,"Lavaca County",48285,854,187,1041,0.8203650336
No,Texas,48,"Lee County",48287,402,118,520,0.7730769231
No,Texas,48,"Leon County",48289,591,181,772,0.7655440415
No,Texas,48,"Liberty County",48291,1349,395,1744,0.7735091743
No,Texas,48,"Limestone County",48293,516,157,673,0.7667161961
No,Texas,48,"Lipscomb County",48295,87,26,113,0.7699115044
No,Texas,48,"Live Oak County",48297,257,80,337,0.762611276
No,Texas,48,"Llano County",48299,887,197,1084,0.8182656827
No,Texas,48,"Loving County",48301,.,0,.,1
No,Texas,48,"Lubbock County",48303,4798,1153,5951,0.8062510502
No,Texas,48,"Lynn County",48305,104,25,129,0.8062015504
No,Texas,48,"McCulloch County",48307,276,65,341,0.8093841642
No,Texas,48,"McLennan County",48309,3600,918,4518,0.796812749
No,Texas,48,"McMullen County",48311,.,.,.,0.8275862069
No,Texas,48,"Madison County",48313,271,69,340,0.7970588235
No,Texas,48,"Marion County",48315,289,70,359,0.8050139276
No,Texas,48,"Martin County",48317,81,23,104,0.7788461538
No,Texas,48,"Mason County",48319,185,37,222,0.8333333333
No,Texas,48,"Matagorda County",48321,773,229,1002,0.7714570858
No,Texas,48,"Maverick County",48323,314,109,423,0.7423167849
No,Texas,48,"Medina County",48325,676,180,856,0.7897196262
No,Texas,48,"Menard County",48327,64,14,78,0.8205128205
No,Texas,48,"Midland County",48329,2038,505,2543,0.8014156508
No,Texas,48,"Milam County",48331,453,114,567,0.7989417989
No,Texas,48,"Mills County",48333,158,29,187,0.8449197861
No,Texas,48,"Mitchell County",48335,180,47,227,0.7929515419
No,Texas,48,"Montague County",48337,680,156,836,0.8133971292
No,Texas,48,"Montgomery County",48339,9588,2459,12047,0.7958827924
No,Texas,48,"Moore County",48341,311,86,397,0.7833753149
No,Texas,48,"Morris County",48343,363,96,459,0.7908496732
No,Texas,48,"Motley County",48345,.,.,.,0.8936170213
No,Texas,48,"Nacogdoches County",48347,1314,380,1694,0.7756788666
No,Texas,48,"Navarro County",48349,1037,309,1346,0.7704309064
No,Texas,48,"Newton County",48351,329,89,418,0.7870813397
No,Texas,48,"Nolan County",48353,356,94,450,0.7911111111
No,Texas,48,"Nueces County",48355,2902,838,3740,0.7759358289
No,Texas,48,"Ochiltree County",48357,185,45,230,0.8043478261
No,Texas,48,"Oldham County",48359,59,11,70,0.8428571429
No,Texas,48,"Orange County",48361,1963,512,2475,0.7931313131
No,Texas,48,"Palo Pinto County",48363,770,191,961,0.8012486993
No,Texas,48,"Panola County",48365,683,156,839,0.8140643623
No,Texas,48,"Parker County",48367,3175,776,3951,0.8035940268
No,Texas,48,"Parmer County",48369,213,52,265,0.8037735849
No,Texas,48,"Pecos County",48371,189,70,259,0.7297297297
No,Texas,48,"Polk County",48373,2123,552,2675,0.7936448598
No,Texas,48,"Potter County",48375,1876,486,2362,0.7942421677
No,Texas,48,"Presidio County",48377,43,20,63,0.6825396825
No,Texas,48,"Rains County",48379,375,103,478,0.7845188285
No,Texas,48,"Randall County",48381,3469,740,4209,0.8241862675
No,Texas,48,"Reagan County",48383,.,.,.,0.8431372549
No,Texas,48,"Real County",48385,115,25,140,0.8214285714
No,Texas,48,"Red River County",48387,345,119,464,0.7435344828
No,Texas,48,"Reeves County",48389,182,67,249,0.7309236948
No,Texas,48,"Refugio County",48391,166,54,220,0.7545454545
No,Texas,48,"Roberts County",48393,.,.,.,0.8837209302
No,Texas,48,"Robertson County",48395,392,88,480,0.8166666667
No,Texas,48,"Rockwall County",48397,1765,435,2200,0.8022727273
No,Texas,48,"Runnels County",48399,388,100,488,0.7950819672
No,Texas,48,"Rusk County",48401,1209,320,1529,0.7907128842
No,Texas,48,"Sabine County",48403,466,123,589,0.7911714771
No,Texas,48,"San Augustine County",48405,287,63,350,0.82
No,Texas,48,"San Jacinto County",48407,627,192,819,0.7655677656
No,Texas,48,"San Patricio County",48409,776,223,999,0.7767767768
No,Texas,48,"San Saba County",48411,190,40,230,0.8260869565
No,Texas,48,"Schleicher County",48413,76,14,90,0.8444444444
No,Texas,48,"Scurry County",48415,434,92,526,0.825095057
No,Texas,48,"Shackelford County",48417,118,31,149,0.7919463087
No,Texas,48,"Shelby County",48419,543,130,673,0.8068350669
No,Texas,48,"Sherman County",48421,57,13,70,0.8142857143
No,Texas,48,"Smith County",48423,5757,1515,7272,0.7916666667
No,Texas,48,"Somervell County",48425,227,56,283,0.8021201413
No,Texas,48,"Starr County",48427,299,113,412,0.7257281553
No,Texas,48,"Stephens County",48429,271,66,337,0.8041543027
No,Texas,48,"Sterling County",48431,.,.,.,0.8333333333
No,Texas,48,"Stonewall County",48433,.,.,.,0.8831168831
No,Texas,48,"Sutton County",48435,97,29,126,0.7698412698
No,Texas,48,"Swisher County",48437,194,58,252,0.7698412698
No,Texas,48,"Tarrant County",48439,21402,5506,26908,0.7953768396
No,Texas,48,"Taylor County",48441,2702,621,3323,0.8131206741
No,Texas,48,"Terrell County",48443,.,.,.,0.724137931
No,Texas,48,"Terry County",48445,157,59,216,0.7268518519
No,Texas,48,"Throckmorton County",48447,74,19,93,0.7956989247
No,Texas,48,"Titus County",48449,644,156,800,0.805
No,Texas,48,"Tom Green County",48451,2587,607,3194,0.8099561678
No,Texas,48,"Travis County",48453,11042,2630,13672,0.8076360445
No,Texas,48,"Trinity County",48455,497,144,641,0.775351014
No,Texas,48,"Tyler County",48457,598,173,771,0.775616083
No,Texas,48,"Upshur County",48459,1024,233,1257,0.814638027
No,Texas,48,"Upton County",48461,60,14,74,0.8108108108
No,Texas,48,"Uvalde County",48463,431,109,540,0.7981481481
No,Texas,48,"Val Verde County",48465,400,122,522,0.7662835249
No,Texas,48,"Van Zandt County",48467,1558,349,1907,0.8169900367
No,Texas,48,"Victoria County",48469,2124,511,2635,0.8060721063
No,Texas,48,"Walker County",48471,1125,338,1463,0.7689678742
No,Texas,48,"Waller County",48473,794,253,1047,0.7583572111
No,Texas,48,"Ward County",48475,240,67,307,0.7817589577
No,Texas,48,"Washington County",48477,1212,264,1476,0.8211382114
No,Texas,48,"Webb County",48479,1247,454,1701,0.7330981775
No,Texas,48,"Wharton County",48481,1144,301,1445,0.7916955017
No,Texas,48,"Wheeler County",48483,178,34,212,0.8396226415
No,Texas,48,"Wichita County",48485,2739,656,3395,0.8067746686
No,Texas,48,"Wilbarger County",48487,278,84,362,0.7679558011
No,Texas,48,"Willacy County",48489,190,47,237,0.8016877637
No,Texas,48,"Williamson County",48491,8207,1731,9938,0.8258200845
No,Texas,48,"Wilson County",48493,746,186,932,0.8004291845
No,Texas,48,"Winkler County",48495,112,40,152,0.7368421053
No,Texas,48,"Wise County",48497,1480,386,1866,0.7931404073
No,Texas,48,"Wood County",48499,1989,479,2468,0.8059157212
No,Texas,48,"Yoakum County",48501,132,43,175,0.7542857143
No,Texas,48,"Young County",48503,627,183,810,0.7740740741
No,Texas,48,"Zapata County",48505,130,30,160,0.8125
No,Texas,48,"Zavala County",48507,99,42,141,0.7021276596
No,Texas,48,,48999,225,70,295,0.7627118644
No,Utah,49,"Beaver County",49001,130,32,162,0.8024691358
No,Utah,49,"Box Elder County",49003,487,122,609,0.7996715928
No,Utah,49,"Cache County",49005,786,201,987,0.7963525836
No,Utah,49,"Carbon County",49007,440,131,571,0.7705779335
No,Utah,49,"Daggett County",49009,.,.,.,0.6
No,Utah,49,"Davis County",49011,1909,505,2414,0.7908036454
No,Utah,49,"Duchesne County",49013,217,76,293,0.7406143345
No,Utah,49,"Emery County",49015,203,59,262,0.7748091603
No,Utah,49,"Garfield County",49017,117,25,142,0.823943662
No,Utah,49,"Grand County",49019,174,41,215,0.8093023256
No,Utah,49,"Iron County",49021,813,177,990,0.8212121212
No,Utah,49,"Juab County",49023,194,52,246,0.7886178862
No,Utah,49,"Kane County",49025,187,46,233,0.8025751073
No,Utah,49,"Millard County",49027,254,63,317,0.8012618297
No,Utah,49,"Morgan County",49029,95,22,117,0.811965812
No,Utah,49,"Piute County",49031,.,.,.,0.8783783784
No,Utah,49,"Rich County",49033,.,.,.,0.7368421053
No,Utah,49,"Salt Lake County",49035,7455,1844,9299,0.8016991074
No,Utah,49,"San Juan County",49037,123,32,155,0.7935483871
No,Utah,49,"Sanpete County",49039,406,121,527,0.770398482
No,Utah,49,"Sevier County",49041,441,102,543,0.8121546961
No,Utah,49,"Summit County",49043,350,107,457,0.7658643326
No,Utah,49,"Tooele County",49045,402,128,530,0.758490566
No,Utah,49,"Uintah County",49047,347,88,435,0.7977011494
No,Utah,49,"Utah County",49049,3630,971,4601,0.788958922
No,Utah,49,"Wasatch County",49051,287,66,353,0.8130311615
No,Utah,49,"Washington County",49053,3788,871,4659,0.8130500107
No,Utah,49,"Wayne County",49055,.,.,.,0.8630136986
No,Utah,49,"Weber County",49057,1458,413,1871,0.7792624265
No,Utah,49,,49999,.,.,.,0.75
No,Vermont,50,"Addison County",50001,980,137,1117,0.8773500448
No,Vermont,50,"Bennington County",50003,1141,217,1358,0.8402061856
No,Vermont,50,"Caledonia County",50005,795,125,920,0.8641304348
No,Vermont,50,"Chittenden County",50007,3102,532,3634,0.8536048431
No,Vermont,50,"Essex County",50009,201,32,233,0.8626609442
No,Vermont,50,"Franklin County",50011,1089,176,1265,0.8608695652
No,Vermont,50,"Grand Isle County",50013,199,35,234,0.8504273504
No,Vermont,50,"Lamoille County",50015,496,78,574,0.8641114983
No,Vermont,50,"Orange County",50017,827,122,949,0.8714436249
No,Vermont,50,"Orleans County",50019,941,138,1079,0.8721037998
No,Vermont,50,"Rutland County",50021,1954,287,2241,0.8719321731
No,Vermont,50,"Washington County",50023,1543,274,1817,0.8492019813
No,Vermont,50,"Windham County",50025,1378,236,1614,0.85377943
No,Vermont,50,"Windsor County",50027,1858,329,2187,0.849565615
No,Vermont,50,,50999,.,0,.,1
No,Virginia,51,"Accomack County",51001,1126,231,1357,0.8297715549
No,Virginia,51,"Albemarle County",51003,2408,421,2829,0.851184164
No,Virginia,51,"Alleghany County",51005,611,140,751,0.8135818908
No,Virginia,51,"Amelia County",51007,332,68,400,0.83
No,Virginia,51,"Amherst County",51009,1031,198,1229,0.8388934093
No,Virginia,51,"Appomattox County",51011,500,114,614,0.8143322476
No,Virginia,51,"Arlington County",51013,1318,262,1580,0.8341772152
No,Virginia,51,"Augusta County",51015,2591,491,3082,0.840687865
No,Virginia,51,"Bath County",51017,190,42,232,0.8189655172
No,Virginia,51,"Bedford County",51019,2562,524,3086,0.8302009073
No,Virginia,51,"Bland County",51021,281,51,332,0.8463855422
No,Virginia,51,"Botetourt County",51023,1051,249,1300,0.8084615385
No,Virginia,51,"Brunswick County",51025,428,93,521,0.8214971209
No,Virginia,51,"Buchanan County",51027,831,221,1052,0.7899239544
No,Virginia,51,"Buckingham County",51029,378,75,453,0.8344370861
No,Virginia,51,"Campbell County",51031,1763,356,2119,0.8319962246
No,Virginia,51,"Caroline County",51033,623,149,772,0.8069948187
No,Virginia,51,"Carroll County",51035,1093,261,1354,0.8072378139
No,Virginia,51,"Charles City County",51036,240,35,275,0.8727272727
No,Virginia,51,"Charlotte County",51037,402,78,480,0.8375
No,Virginia,51,"Chesterfield County",51041,6803,1314,8117,0.8381175311
No,Virginia,51,"Clarke County",51043,413,86,499,0.8276553106
No,Virginia,51,"Craig County",51045,149,34,183,0.8142076503
No,Virginia,51,"Culpeper County",51047,1025,184,1209,0.8478081059
No,Virginia,51,"Cumberland County",51049,244,54,298,0.8187919463
No,Virginia,51,"Dickenson County",51051,549,145,694,0.7910662824
No,Virginia,51,"Dinwiddie County",51053,754,164,918,0.8213507625
No,Virginia,51,"Essex County",51057,357,81,438,0.8150684932
No,Virginia,51,"Fairfax County",51059,8937,1854,10791,0.8281901585
No,Virginia,51,"Fauquier County",51061,1351,283,1634,0.8268053856
No,Virginia,51,"Floyd County",51063,525,101,626,0.838658147
No,Virginia,51,"Fluvanna County",51065,764,149,913,0.8368017525
No,Virginia,51,"Franklin County",51067,1634,366,2000,0.817
No,Virginia,51,"Frederick County",51069,2233,365,2598,0.8595073133
No,Virginia,51,"Giles County",51071,636,134,770,0.825974026
No,Virginia,51,"Gloucester County",51073,957,204,1161,0.8242894057
No,Virginia,51,"Goochland County",51075,684,146,830,0.8240963855
No,Virginia,51,"Grayson County",51077,550,129,679,0.8100147275
No,Virginia,51,"Greene County",51079,460,86,546,0.8424908425
No,Virginia,51,"Greensville County",51081,257,61,318,0.8081761006
No,Virginia,51,"Halifax County",51083,1306,275,1581,0.826059456
No,Virginia,51,"Hanover County",51085,2844,542,3386,0.8399291199
No,Virginia,51,"Henrico County",51087,6370,1299,7669,0.8306167688
No,Virginia,51,"Henry County",51089,1821,344,2165,0.841108545
No,Virginia,51,"Highland County",51091,97,24,121,0.8016528926
No,Virginia,51,"Isle of Wight County",51093,872,174,1046,0.8336520076
No,Virginia,51,"James City County",51095,2457,421,2878,0.8537178596
No,Virginia,51,"King and Queen County",51097,221,40,261,0.846743295
No,Virginia,51,"King George County",51099,330,71,401,0.8229426434
No,Virginia,51,"King William County",51101,551,108,659,0.8361153263
No,Virginia,51,"Lancaster County",51103,506,115,621,0.8148148148
No,Virginia,51,"Lee County",51105,515,113,628,0.8200636943
No,Virginia,51,"Loudoun County",51107,3410,679,4089,0.8339447298
No,Virginia,51,"Louisa County",51109,957,154,1111,0.8613861386
No,Virginia,51,"Lunenburg County",51111,347,78,425,0.8164705882
No,Virginia,51,"Madison County",51113,354,73,427,0.8290398126
No,Virginia,51,"Mathews County",51115,376,68,444,0.8468468468
No,Virginia,51,"Mecklenburg County",51117,1216,271,1487,0.8177538668
No,Virginia,51,"Middlesex County",51119,442,96,538,0.8215613383
No,Virginia,51,"Montgomery County",51121,1731,389,2120,0.816509434
No,Virginia,51,"Nelson County",51125,530,93,623,0.8507223114
No,Virginia,51,"New Kent County",51127,595,109,704,0.8451704545
No,Virginia,51,"Northampton County",51131,418,104,522,0.8007662835
No,Virginia,51,"Northumberland County",51133,542,100,642,0.8442367601
No,Virginia,51,"Nottoway County",51135,390,99,489,0.7975460123
No,Virginia,51,"Orange County",51137,1043,207,1250,0.8344
No,Virginia,51,"Page County",51139,768,137,905,0.8486187845
No,Virginia,51,"Patrick County",51141,685,137,822,0.8333333333
No,Virginia,51,"Pittsylvania County",51143,2095,415,2510,0.8346613546
No,Virginia,51,"Powhatan County",51145,793,157,950,0.8347368421
No,Virginia,51,"Prince Edward County",51147,464,112,576,0.8055555556
No,Virginia,51,"Prince George County",51149,675,167,842,0.8016627078
No,Virginia,51,"Prince William County",51153,3577,754,4331,0.8259062572
No,Virginia,51,"Pulaski County",51155,1258,283,1541,0.8163530175
No,Virginia,51,"Rappahannock County",51157,216,47,263,0.8212927757
No,Virginia,51,"Richmond County",51159,226,49,275,0.8218181818
No,Virginia,51,"Roanoke County",51161,3135,697,3832,0.8181106472
No,Virginia,51,"Rockbridge County",51163,769,162,931,0.8259935553
No,Virginia,51,"Rockingham County",51165,2644,467,3111,0.849887496
No,Virginia,51,"Russell County",51167,963,191,1154,0.8344887348
No,Virginia,51,"Scott County",51169,510,89,599,0.8514190317
No,Virginia,51,"Shenandoah County",51171,1454,249,1703,0.8537874339
No,Virginia,51,"Smyth County",51173,1017,211,1228,0.8281758958
No,Virginia,51,"Southampton County",51175,528,109,637,0.8288854003
No,Virginia,51,"Spotsylvania County",51177,2342,469,2811,0.8331554607
No,Virginia,51,"Stafford County",51179,1585,385,1970,0.8045685279
No,Virginia,51,"Surry County",51181,173,42,215,0.8046511628
No,Virginia,51,"Sussex County",51183,268,70,338,0.7928994083
No,Virginia,51,"Tazewell County",51185,1507,345,1852,0.8137149028
No,Virginia,51,"Warren County",51187,957,192,1149,0.8328981723
No,Virginia,51,"Washington County",51191,1683,428,2111,0.797252487
No,Virginia,51,"Westmoreland County",51193,515,116,631,0.8161648177
No,Virginia,51,"Wise County",51195,1011,223,1234,0.819286872
No,Virginia,51,"Wythe County",51197,973,259,1232,0.7897727273
No,Virginia,51,"York County",51199,1142,223,1365,0.8366300366
No,Virginia,51,"Alexandria city",51510,1083,204,1287,0.8414918415
No,Virginia,51,"Bedford city",51515,.,0,.,1
No,Virginia,51,"Bristol city",51520,409,88,497,0.8229376258
No,Virginia,51,"Buena Vista city",51530,238,31,269,0.8847583643
No,Virginia,51,"Charlottesville city",51540,596,136,732,0.8142076503
No,Virginia,51,"Chesapeake city",51550,3279,803,4082,0.8032827046
No,Virginia,51,"Colonial Heights city",51570,513,80,593,0.8650927487
No,Virginia,51,"Covington city",51580,212,54,266,0.7969924812
No,Virginia,51,"Danville city",51590,1143,325,1468,0.7786103542
No,Virginia,51,"Emporia city",51595,128,30,158,0.8101265823
No,Virginia,51,"Fairfax city",51600,250,49,299,0.8361204013
No,Virginia,51,"Falls Church city",51610,148,34,182,0.8131868132
No,Virginia,51,"Franklin city",51620,245,74,319,0.7680250784
No,Virginia,51,"Fredericksburg city",51630,408,101,509,0.8015717092
No,Virginia,51,"Galax city",51640,209,50,259,0.8069498069
No,Virginia,51,"Hampton city",51650,1823,462,2285,0.7978118162
No,Virginia,51,"Harrisonburg city",51660,659,112,771,0.8547341115
No,Virginia,51,"Hopewell city",51670,384,106,490,0.7836734694
No,Virginia,51,"Lexington city",51678,141,34,175,0.8057142857
No,Virginia,51,"Lynchburg city",51680,1634,353,1987,0.8223452441
No,Virginia,51,"Manassas city",51683,424,82,506,0.837944664
No,Virginia,51,"Manassas Park city",51685,108,17,125,0.864
No,Virginia,51,"Martinsville city",51690,364,101,465,0.7827956989
No,Virginia,51,"Newport News city",51700,2193,530,2723,0.8053617334
No,Virginia,51,"Norfolk city",51710,1990,494,2484,0.8011272142
No,Virginia,51,"Norton city",51720,122,23,145,0.8413793103
No,Virginia,51,"Petersburg city",51730,523,191,714,0.7324929972
No,Virginia,51,"Poquoson city",51735,255,43,298,0.855704698
No,Virginia,51,"Portsmouth city",51740,1202,308,1510,0.7960264901
No,Virginia,51,"Radford city",51750,273,70,343,0.7959183673
No,Virginia,51,"Richmond city",51760,2573,674,3247,0.7924237758
No,Virginia,51,"Roanoke city",51770,1905,456,2361,0.8068614994
No,Virginia,51,"Salem city",51775,704,176,880,0.8
No,Virginia,51,"Staunton city",51790,809,156,965,0.8383419689
No,Virginia,51,"Suffolk city",51800,1524,363,1887,0.8076311606
No,Virginia,51,"Virginia Beach city",51810,5893,1282,7175,0.8213240418
No,Virginia,51,"Waynesboro city",51820,642,131,773,0.830530401
No,Virginia,51,"Williamsburg city",51830,296,55,351,0.8433048433
No,Virginia,51,"Winchester city",51840,683,136,819,0.8339438339
No,Virginia,51,,51867,.,.,.,0.6
No,Virginia,51,,51999,52,21,73,0.7123287671
No,Washington,53,"Adams County",53001,210,75,285,0.7368421053
No,Washington,53,"Asotin County",53003,620,133,753,0.823373174
No,Washington,53,"Benton County",53005,4323,902,5225,0.8273684211
No,Washington,53,"Chelan County",53007,1350,256,1606,0.8405977584
No,Washington,53,"Clallam County",53009,2971,567,3538,0.8397399661
No,Washington,53,"Clark County",53011,4103,855,4958,0.827551432
No,Washington,53,"Columbia County",53013,108,21,129,0.8372093023
No,Washington,53,"Cowlitz County",53015,1695,343,2038,0.8316977429
No,Washington,53,"Douglas County",53017,757,143,900,0.8411111111
No,Washington,53,"Ferry County",53019,149,41,190,0.7842105263
No,Washington,53,"Franklin County",53021,1084,254,1338,0.8101644245
No,Washington,53,"Garfield County",53023,65,18,83,0.7831325301
No,Washington,53,"Grant County",53025,1509,340,1849,0.8161168199
No,Washington,53,"Grays Harbor County",53027,2028,456,2484,0.8164251208
No,Washington,53,"Island County",53029,1764,333,2097,0.8412017167
No,Washington,53,"Jefferson County",53031,1281,287,1568,0.8169642857
No,Washington,53,"King County",53033,20464,4221,24685,0.8290054689
No,Washington,53,"Kitsap County",53035,3355,667,4022,0.8341621084
No,Washington,53,"Kittitas County",53037,806,166,972,0.829218107
No,Washington,53,"Klickitat County",53039,602,120,722,0.8337950139
No,Washington,53,"Lewis County",53041,1552,366,1918,0.8091762252
No,Washington,53,"Lincoln County",53043,316,63,379,0.8337730871
No,Washington,53,"Mason County",53045,1352,290,1642,0.8233861145
No,Washington,53,"Okanogan County",53047,723,168,891,0.8114478114
No,Washington,53,"Pacific County",53049,1054,207,1261,0.8358445678
No,Washington,53,"Pend Oreille County",53051,345,77,422,0.817535545
No,Washington,53,"Pierce County",53053,9849,2131,11980,0.8221202003
No,Washington,53,"San Juan County",53055,536,124,660,0.8121212121
No,Washington,53,"Skagit County",53057,2928,615,3543,0.8264182896
No,Washington,53,"Skamania County",53059,238,52,290,0.8206896552
No,Washington,53,"Snohomish County",53061,8197,1683,9880,0.8296558704
No,Washington,53,"Spokane County",53063,6078,1422,7500,0.8104
No,Washington,53,"Stevens County",53065,1042,238,1280,0.8140625
No,Washington,53,"Thurston County",53067,2988,645,3633,0.8224607762
No,Washington,53,"Wahkiakum County",53069,153,32,185,0.827027027
No,Washington,53,"Walla Walla County",53071,1172,245,1417,0.827099506
No,Washington,53,"Whatcom County",53073,3734,810,4544,0.8217429577
No,Washington,53,"Whitman County",53075,495,132,627,0.7894736842
No,Washington,53,"Yakima County",53077,3659,787,4446,0.8229869546
No,Washington,53,,53999,54,12,66,0.8181818182
No,"West Virginia",54,"Barbour County",54001,382,57,439,0.8701594533
No,"West Virginia",54,"Berkeley County",54003,2152,443,2595,0.8292870906
No,"West Virginia",54,"Boone County",54005,421,123,544,0.7738970588
No,"West Virginia",54,"Braxton County",54007,301,63,364,0.8269230769
No,"West Virginia",54,"Brooke County",54009,708,175,883,0.8018120045
No,"West Virginia",54,"Cabell County",54011,1805,425,2230,0.8094170404
No,"West Virginia",54,"Calhoun County",54013,180,28,208,0.8653846154
No,"West Virginia",54,"Clay County",54015,160,36,196,0.8163265306
No,"West Virginia",54,"Doddridge County",54017,137,30,167,0.8203592814
No,"West Virginia",54,"Fayette County",54019,871,210,1081,0.8057354302
No,"West Virginia",54,"Gilmer County",54021,115,33,148,0.777027027
No,"West Virginia",54,"Grant County",54023,356,59,415,0.8578313253
No,"West Virginia",54,"Greenbrier County",54025,944,223,1167,0.8089117395
No,"West Virginia",54,"Hampshire County",54027,619,114,733,0.8444747613
No,"West Virginia",54,"Hancock County",54029,1114,280,1394,0.7991391679
No,"West Virginia",54,"Hardy County",54031,370,64,434,0.8525345622
No,"West Virginia",54,"Harrison County",54033,1479,302,1781,0.8304323414
No,"West Virginia",54,"Jackson County",54035,710,134,844,0.8412322275
No,"West Virginia",54,"Jefferson County",54037,988,201,1189,0.8309503785
No,"West Virginia",54,"Kanawha County",54039,4486,1024,5510,0.8141560799
No,"West Virginia",54,"Lewis County",54041,347,70,417,0.8321342926
No,"West Virginia",54,"Lincoln County",54043,424,119,543,0.7808471455
No,"West Virginia",54,"Logan County",54045,820,223,1043,0.7861936721
No,"West Virginia",54,"McDowell County",54047,398,126,524,0.7595419847
No,"West Virginia",54,"Marion County",54049,1250,212,1462,0.8549931601
No,"West Virginia",54,"Marshall County",54051,763,134,897,0.850613155
No,"West Virginia",54,"Mason County",54053,706,158,864,0.8171296296
No,"West Virginia",54,"Mercer County",54055,1491,350,1841,0.8098859316
No,"West Virginia",54,"Mineral County",54057,1057,173,1230,0.8593495935
No,"West Virginia",54,"Mingo County",54059,557,138,695,0.8014388489
No,"West Virginia",54,"Monongalia County",54061,1291,216,1507,0.8566688786
No,"West Virginia",54,"Monroe County",54063,404,87,491,0.8228105906
No,"West Virginia",54,"Morgan County",54065,465,98,563,0.8259325044
No,"West Virginia",54,"Nicholas County",54067,695,122,817,0.8506731946
No,"West Virginia",54,"Ohio County",54069,860,180,1040,0.8269230769
No,"West Virginia",54,"Pendleton County",54071,224,33,257,0.8715953307
No,"West Virginia",54,"Pleasants County",54073,212,50,262,0.8091603053
No,"West Virginia",54,"Pocahontas County",54075,196,51,247,0.7935222672
No,"West Virginia",54,"Preston County",54077,836,148,984,0.8495934959
No,"West Virginia",54,"Putnam County",54079,1450,312,1762,0.8229284904
No,"West Virginia",54,"Raleigh County",54081,1754,391,2145,0.8177156177
No,"West Virginia",54,"Randolph County",54083,698,131,829,0.8419782871
No,"West Virginia",54,"Ritchie County",54085,278,57,335,0.8298507463
No,"West Virginia",54,"Roane County",54087,312,81,393,0.7938931298
No,"West Virginia",54,"Summers County",54089,288,81,369,0.7804878049
No,"West Virginia",54,"Taylor County",54091,361,75,436,0.8279816514
No,"West Virginia",54,"Tucker County",54093,201,52,253,0.7944664032
No,"West Virginia",54,"Tyler County",54095,257,37,294,0.8741496599
No,"West Virginia",54,"Upshur County",54097,568,98,666,0.8528528529
No,"West Virginia",54,"Wayne County",54099,920,220,1140,0.8070175439
No,"West Virginia",54,"Webster County",54101,213,55,268,0.7947761194
No,"West Virginia",54,"Wetzel County",54103,427,78,505,0.8455445545
No,"West Virginia",54,"Wirt County",54105,154,38,192,0.8020833333
No,"West Virginia",54,"Wood County",54107,2541,517,3058,0.8309352518
No,"West Virginia",54,"Wyoming County",54109,519,138,657,0.7899543379
No,"West Virginia",54,,54999,.,.,.,0.9032258065
No,Wisconsin,55,"Adams County",55001,806,107,913,0.882803943
No,Wisconsin,55,"Ashland County",55003,366,56,422,0.8672985782
No,Wisconsin,55,"Barron County",55005,1024,150,1174,0.8722316865
No,Wisconsin,55,"Bayfield County",55007,407,76,483,0.8426501035
No,Wisconsin,55,"Brown County",55009,3919,519,4438,0.8830554304
No,Wisconsin,55,"Buffalo County",55011,455,73,528,0.8617424242
No,Wisconsin,55,"Burnett County",55013,524,98,622,0.8424437299
No,Wisconsin,55,"Calumet County",55015,677,98,775,0.8735483871
No,Wisconsin,55,"Chippewa County",55017,1498,187,1685,0.8890207715
No,Wisconsin,55,"Clark County",55019,422,62,484,0.8719008264
No,Wisconsin,55,"Columbia County",55021,1393,202,1595,0.873354232
No,Wisconsin,55,"Crawford County",55023,442,60,502,0.8804780876
No,Wisconsin,55,"Dane County",55025,8372,1124,9496,0.8816343724
No,Wisconsin,55,"Dodge County",55027,2233,289,2522,0.885408406
No,Wisconsin,55,"Door County",55029,1426,180,1606,0.8879202989
No,Wisconsin,55,"Douglas County",55031,711,111,822,0.8649635036
No,Wisconsin,55,"Dunn County",55033,893,122,1015,0.8798029557
No,Wisconsin,55,"Eau Claire County",55035,2206,303,2509,0.8792347549
No,Wisconsin,55,"Florence County",55037,136,33,169,0.8047337278
No,Wisconsin,55,"Fond du Lac County",55039,2064,317,2381,0.8668626627
No,Wisconsin,55,"Forest County",55041,223,40,263,0.8479087452
No,Wisconsin,55,"Grant County",55043,1021,130,1151,0.887054735
No,Wisconsin,55,"Green County",55045,1042,141,1183,0.8808114962
No,Wisconsin,55,"Green Lake County",55047,418,64,482,0.867219917
No,Wisconsin,55,"Iowa County",55049,505,79,584,0.8647260274
No,Wisconsin,55,"Iron County",55051,159,23,182,0.8736263736
No,Wisconsin,55,"Jackson County",55053,457,62,519,0.880539499
No,Wisconsin,55,"Jefferson County",55055,2047,286,2333,0.8774110587
No,Wisconsin,55,"Juneau County",55057,761,92,853,0.8921453693
No,Wisconsin,55,"Kenosha County",55059,3134,488,3622,0.8652678078
No,Wisconsin,55,"Kewaunee County",55061,452,58,510,0.8862745098
No,Wisconsin,55,"La Crosse County",55063,2150,279,2429,0.8851379168
No,Wisconsin,55,"Lafayette County",55065,396,63,459,0.862745098
No,Wisconsin,55,"Langlade County",55067,500,72,572,0.8741258741
No,Wisconsin,55,"Lincoln County",55069,740,112,852,0.8685446009
No,Wisconsin,55,"Manitowoc County",55071,2183,298,2481,0.8798871423
No,Wisconsin,55,"Marathon County",55073,2450,344,2794,0.8768790265
No,Wisconsin,55,"Marinette County",55075,1247,233,1480,0.8425675676
No,Wisconsin,55,"Marquette County",55077,476,68,544,0.875
No,Wisconsin,55,"Menominee County",55078,.,.,.,0.8163265306
No,Wisconsin,55,"Milwaukee County",55079,12730,2320,15050,0.8458471761
No,Wisconsin,55,"Monroe County",55081,710,90,800,0.8875
No,Wisconsin,55,"Oconto County",55083,838,148,986,0.8498985801
No,Wisconsin,55,"Oneida County",55085,1341,186,1527,0.8781925344
No,Wisconsin,55,"Outagamie County",55087,2408,319,2727,0.8830216355
No,Wisconsin,55,"Ozaukee County",55089,2204,325,2529,0.8714907078
No,Wisconsin,55,"Pepin County",55091,265,31,296,0.8952702703
No,Wisconsin,55,"Pierce County",55093,614,106,720,0.8527777778
No,Wisconsin,55,"Polk County",55095,1034,161,1195,0.8652719665
No,Wisconsin,55,"Portage County",55097,1366,216,1582,0.8634639697
No,Wisconsin,55,"Price County",55099,391,68,459,0.8518518519
No,Wisconsin,55,"Racine County",55101,4140,709,4849,0.8537842854
No,Wisconsin,55,"Richland County",55103,492,71,563,0.8738898757
No,Wisconsin,55,"Rock County",55105,4268,624,4892,0.8724448078
No,Wisconsin,55,"Rusk County",55107,308,40,348,0.8850574713
No,Wisconsin,55,"St. Croix County",55109,1558,222,1780,0.8752808989
No,Wisconsin,55,"Sauk County",55111,1463,196,1659,0.8818565401
No,Wisconsin,55,"Sawyer County",55113,523,65,588,0.8894557823
No,Wisconsin,55,"Shawano County",55115,768,120,888,0.8648648649
No,Wisconsin,55,"Sheboygan County",55117,2640,338,2978,0.8865010074
No,Wisconsin,55,"Taylor County",55119,366,56,422,0.8672985782
No,Wisconsin,55,"Trempealeau County",55121,703,82,785,0.8955414013
No,Wisconsin,55,"Vernon County",55123,557,70,627,0.8883572568
No,Wisconsin,55,"Vilas County",55125,1116,163,1279,0.8725566849
No,Wisconsin,55,"Walworth County",55127,2739,480,3219,0.8508853681
No,Wisconsin,55,"Washburn County",55129,484,82,566,0.8551236749
No,Wisconsin,55,"Washington County",55131,3606,473,4079,0.8840402059
No,Wisconsin,55,"Waukesha County",55133,10363,1523,11886,0.8718660609
No,Wisconsin,55,"Waupaca County",55135,996,123,1119,0.890080429
No,Wisconsin,55,"Waushara County",55137,489,73,562,0.8701067616
No,Wisconsin,55,"Winnebago County",55139,2543,366,2909,0.8741835682
No,Wisconsin,55,"Wood County",55141,1491,184,1675,0.8901492537
No,Wisconsin,55,,55999,83,13,96,0.8645833333
No,Wyoming,56,"Albany County",56001,489,119,608,0.8042763158
No,Wyoming,56,"Big Horn County",56003,307,77,384,0.7994791667
No,Wyoming,56,"Campbell County",56005,768,143,911,0.8430296378
No,Wyoming,56,"Carbon County",56007,299,71,370,0.8081081081
No,Wyoming,56,"Converse County",56009,346,79,425,0.8141176471
No,Wyoming,56,"Crook County",56011,224,35,259,0.8648648649
No,Wyoming,56,"Fremont County",56013,818,182,1000,0.818
No,Wyoming,56,"Goshen County",56015,432,83,515,0.8388349515
No,Wyoming,56,"Hot Springs County",56017,184,36,220,0.8363636364
No,Wyoming,56,"Johnson County",56019,256,54,310,0.8258064516
No,Wyoming,56,"Laramie County",56021,1880,406,2286,0.8223972003
No,Wyoming,56,"Lincoln County",56023,360,94,454,0.7929515419
No,Wyoming,56,"Natrona County",56025,1632,341,1973,0.8271667511
No,Wyoming,56,"Niobrara County",56027,72,15,87,0.8275862069
No,Wyoming,56,"Park County",56029,978,182,1160,0.8431034483
No,Wyoming,56,"Platte County",56031,317,91,408,0.7769607843
No,Wyoming,56,"Sheridan County",56033,691,129,820,0.8426829268
No,Wyoming,56,"Sublette County",56035,133,34,167,0.7964071856
No,Wyoming,56,"Sweetwater County",56037,678,174,852,0.7957746479
No,Wyoming,56,"Teton County",56039,243,78,321,0.7570093458
No,Wyoming,56,"Uinta County",56041,348,70,418,0.8325358852
No,Wyoming,56,"Washakie County",56043,257,54,311,0.8263665595
No,Wyoming,56,"Weston County",56045,152,51,203,0.7487684729
No,Wyoming,56,,56999,.,0,.,1
Yes,Alabama,1,"Autauga County",1001,276,97,373,0.7399463807
Yes,Alabama,1,"Baldwin County",1003,765,248,1013,0.7551826259
Yes,Alabama,1,"Barbour County",1005,329,165,494,0.6659919028
Yes,Alabama,1,"Bibb County",1007,184,95,279,0.6594982079
Yes,Alabama,1,"Blount County",1009,337,112,449,0.7505567929
Yes,Alabama,1,"Bullock County",1011,167,75,242,0.6900826446
Yes,Alabama,1,"Butler County",1013,354,130,484,0.7314049587
Yes,Alabama,1,"Calhoun County",1015,1141,389,1530,0.745751634
Yes,Alabama,1,"Chambers County",1017,532,202,734,0.7247956403
Yes,Alabama,1,"Cherokee County",1019,359,112,471,0.7622080679
Yes,Alabama,1,"Chilton County",1021,266,100,366,0.7267759563
Yes,Alabama,1,"Choctaw County",1023,306,84,390,0.7846153846
Yes,Alabama,1,"Clarke County",1025,343,138,481,0.7130977131
Yes,Alabama,1,"Clay County",1027,222,76,298,0.744966443
Yes,Alabama,1,"Cleburne County",1029,194,46,240,0.8083333333
Yes,Alabama,1,"Coffee County",1031,409,164,573,0.7137870855
Yes,Alabama,1,"Colbert County",1033,603,230,833,0.7238895558
Yes,Alabama,1,"Conecuh County",1035,251,96,347,0.7233429395
Yes,Alabama,1,"Coosa County",1037,179,89,268,0.6679104478
Yes,Alabama,1,"Covington County",1039,562,249,811,0.69297164
Yes,Alabama,1,"Crenshaw County",1041,198,65,263,0.752851711
Yes,Alabama,1,"Cullman County",1043,900,195,1095,0.8219178082
Yes,Alabama,1,"Dale County",1045,471,191,662,0.7114803625
Yes,Alabama,1,"Dallas County",1047,775,375,1150,0.6739130435
Yes,Alabama,1,"DeKalb County",1049,883,237,1120,0.7883928571
Yes,Alabama,1,"Elmore County",1051,361,152,513,0.7037037037
Yes,Alabama,1,"Escambia County",1053,451,181,632,0.7136075949
Yes,Alabama,1,"Etowah County",1055,1167,423,1590,0.7339622642
Yes,Alabama,1,"Fayette County",1057,249,99,348,0.7155172414
Yes,Alabama,1,"Franklin County",1059,410,121,531,0.7721280603
Yes,Alabama,1,"Geneva County",1061,330,147,477,0.6918238994
Yes,Alabama,1,"Greene County",1063,157,88,245,0.6408163265
Yes,Alabama,1,"Hale County",1065,332,143,475,0.6989473684
Yes,Alabama,1,"Henry County",1067,214,75,289,0.7404844291
Yes,Alabama,1,"Houston County",1069,1168,416,1584,0.7373737374
Yes,Alabama,1,"Jackson County",1071,687,209,896,0.7667410714
Yes,Alabama,1,"Jefferson County",1073,3110,1171,4281,0.726465779
Yes,Alabama,1,"Lamar County",1075,250,91,341,0.7331378299
Yes,Alabama,1,"Lauderdale County",1077,886,294,1180,0.7508474576
Yes,Alabama,1,"Lawrence County",1079,416,121,537,0.7746741155
Yes,Alabama,1,"Lee County",1081,840,319,1159,0.7247627265
Yes,Alabama,1,"Limestone County",1083,632,212,844,0.7488151659
Yes,Alabama,1,"Lowndes County",1085,157,60,217,0.7235023041
Yes,Alabama,1,"Macon County",1087,200,72,272,0.7352941176
Yes,Alabama,1,"Madison County",1089,1601,589,2190,0.7310502283
Yes,Alabama,1,"Marengo County",1091,391,182,573,0.6823734729
Yes,Alabama,1,"Marion County",1093,457,156,613,0.7455138662
Yes,Alabama,1,"Marshall County",1095,1136,315,1451,0.7829083391
Yes,Alabama,1,"Mobile County",1097,2159,931,3090,0.6987055016
Yes,Alabama,1,"Monroe County",1099,313,155,468,0.6688034188
Yes,Alabama,1,"Montgomery County",1101,1269,584,1853,0.6848354021
Yes,Alabama,1,"Morgan County",1103,1018,312,1330,0.7654135338
Yes,Alabama,1,"Perry County",1105,249,128,377,0.6604774536
Yes,Alabama,1,"Pickens County",1107,342,112,454,0.7533039648
Yes,Alabama,1,"Pike County",1109,273,107,380,0.7184210526
Yes,Alabama,1,"Randolph County",1111,321,122,443,0.7246049661
Yes,Alabama,1,"Russell County",1113,492,200,692,0.710982659
Yes,Alabama,1,"St. Clair County",1115,456,151,607,0.7512355848
Yes,Alabama,1,"Shelby County",1117,492,135,627,0.7846889952
Yes,Alabama,1,"Sumter County",1119,235,106,341,0.6891495601
Yes,Alabama,1,"Talladega County",1121,1008,354,1362,0.7400881057
Yes,Alabama,1,"Tallapoosa County",1123,603,268,871,0.6923076923
Yes,Alabama,1,"Tuscaloosa County",1125,1265,507,1772,0.7138826185
Yes,Alabama,1,"Walker County",1127,673,233,906,0.7428256071
Yes,Alabama,1,"Washington County",1129,230,84,314,0.7324840764
Yes,Alabama,1,"Wilcox County",1131,270,118,388,0.6958762887
Yes,Alabama,1,"Winston County",1133,408,112,520,0.7846153846
Yes,Alabama,1,,1212,0,.,.,0
Yes,Alabama,1,,1818,.,0,.,1
Yes,Alabama,1,,1999,34,20,54,0.6296296296
Yes,Alaska,2,"Aleutians East Borough",2013,.,.,.,0.6363636364
Yes,Alaska,2,"Aleutians West Census Area",2016,.,.,.,0.6666666667
Yes,Alaska,2,"Anchorage Borough",2020,1347,437,1784,0.755044843
Yes,Alaska,2,"Bethel Census Area",2050,93,46,139,0.6690647482
Yes,Alaska,2,"Bristol Bay Borough",2060,.,.,.,0.5
Yes,Alaska,2,"Denali Borough (created after 1990)",2068,.,.,.,0.6666666667
Yes,Alaska,2,"Dillingham Census Area",2070,25,13,38,0.6578947368
Yes,Alaska,2,"Fairbanks North Star Borough",2090,267,99,366,0.7295081967
Yes,Alaska,2,"Haines Borough",2100,.,.,.,0.7
Yes,Alaska,2,,2105,.,.,.,0.7058823529
Yes,Alaska,2,"Juneau Borough",2110,149,60,209,0.7129186603
Yes,Alaska,2,"Kenai Peninsula Borough",2122,387,122,509,0.7603143418
Yes,Alaska,2,"Ketchikan Gateway Borough",2130,82,29,111,0.7387387387
Yes,Alaska,2,"Kodiak Island Borough",2150,64,15,79,0.8101265823
Yes,Alaska,2,,2158,44,25,69,0.6376811594
Yes,Alaska,2,"Lake and Peninsula Borough",2164,.,.,.,0.8333333333
Yes,Alaska,2,"Matanuska-Susitna Borough",2170,455,146,601,0.7570715474
Yes,Alaska,2,"Nome Census Area",2180,.,.,.,0.7142857143
Yes,Alaska,2,"North Slope Borough",2185,.,.,.,0.6
Yes,Alaska,2,"Northwest Arctic Borough",2188,40,36,76,0.5263157895
Yes,Alaska,2,,2195,.,.,.,0.9
Yes,Alaska,2,,2198,32,24,56,0.5714285714
Yes,Alaska,2,"Prince of Wales-Outer Ketchikan Census Area",2201,.,0,.,1
Yes,Alaska,2,"Sitka Borough",2220,30,24,54,0.5555555556
Yes,Alaska,2,,2230,.,.,.,0.6666666667
Yes,Alaska,2,"Southeast Fairbanks Census Area",2240,25,15,40,0.625
Yes,Alaska,2,"Valdez-Cordova Census Area",2261,40,15,55,0.7272727273
Yes,Alaska,2,,2275,.,.,.,0.7692307692
Yes,Alaska,2,"Yakutat Borough (created after 1990)",2282,.,0,.,1
Yes,Alaska,2,"Yukon-Koyukuk Census Area",2290,24,24,48,0.5
Yes,Alaska,2,,2626,0,.,.,0
Yes,Alaska,2,,2727,.,0,.,1
Yes,Alaska,2,,2999,.,.,.,0.5
Yes,Arizona,4,"Apache County",4001,351,309,660,0.5318181818
Yes,Arizona,4,"Cochise County",4003,781,298,1079,0.7238183503
Yes,Arizona,4,"Coconino County",4005,357,250,607,0.5881383855
Yes,Arizona,4,"Gila County",4007,389,171,560,0.6946428571
Yes,Arizona,4,"Graham County",4009,150,72,222,0.6756756757
Yes,Arizona,4,"Greenlee County",4011,.,.,.,0.7777777778
Yes,Arizona,4,"La Paz County",4012,125,59,184,0.6793478261
Yes,Arizona,4,"Maricopa County",4013,9004,3689,12693,0.7093673678
Yes,Arizona,4,"Mohave County",4015,1570,544,2114,0.7426679281
Yes,Arizona,4,"Navajo County",4017,500,378,878,0.569476082
Yes,Arizona,4,"Pima County",4019,2729,1161,3890,0.7015424165
Yes,Arizona,4,"Pinal County",4021,1249,551,1800,0.6938888889
Yes,Arizona,4,"Santa Cruz County",4023,256,103,359,0.713091922
Yes,Arizona,4,"Yavapai County",4025,1103,363,1466,0.7523874488
Yes,Arizona,4,"Yuma County",4027,1465,566,2031,0.721319547
Yes,Arizona,4,,4242,.,0,.,1
Yes,Arizona,4,,4747,.,0,.,1
Yes,Arizona,4,,4848,.,.,.,0.6666666667
Yes,Arizona,4,,4999,.,.,.,0.7428571429
Yes,Arkansas,5,"Arkansas County",5001,219,87,306,0.7156862745
Yes,Arkansas,5,"Ashley County",5003,268,134,402,0.6666666667
Yes,Arkansas,5,"Baxter County",5005,433,134,567,0.7636684303
Yes,Arkansas,5,"Benton County",5007,995,320,1315,0.7566539924
Yes,Arkansas,5,"Boone County",5009,366,129,495,0.7393939394
Yes,Arkansas,5,"Bradley County",5011,158,76,234,0.6752136752
Yes,Arkansas,5,"Calhoun County",5013,68,29,97,0.7010309278
Yes,Arkansas,5,"Carroll County",5015,209,91,300,0.6966666667
Yes,Arkansas,5,"Chicot County",5017,221,81,302,0.7317880795
Yes,Arkansas,5,"Clark County",5019,196,70,266,0.7368421053
Yes,Arkansas,5,"Clay County",5021,201,75,276,0.7282608696
Yes,Arkansas,5,"Cleburne County",5023,331,92,423,0.7825059102
Yes,Arkansas,5,"Cleveland County",5025,112,32,144,0.7777777778
Yes,Arkansas,5,"Columbia County",5027,277,120,397,0.6977329975
Yes,Arkansas,5,"Conway County",5029,285,71,356,0.8005617978
Yes,Arkansas,5,"Craighead County",5031,837,296,1133,0.7387466902
Yes,Arkansas,5,"Crawford County",5033,527,206,733,0.7189631651
Yes,Arkansas,5,"Crittenden County",5035,533,308,841,0.6337693222
Yes,Arkansas,5,"Cross County",5037,193,81,274,0.704379562
Yes,Arkansas,5,"Dallas County",5039,88,36,124,0.7096774194
Yes,Arkansas,5,"Desha County",5041,212,132,344,0.6162790698
Yes,Arkansas,5,"Drew County",5043,254,120,374,0.679144385
Yes,Arkansas,5,"Faulkner County",5045,702,236,938,0.7484008529
Yes,Arkansas,5,"Franklin County",5047,172,67,239,0.719665272
Yes,Arkansas,5,"Fulton County",5049,208,59,267,0.7790262172
Yes,Arkansas,5,"Garland County",5051,876,306,1182,0.7411167513
Yes,Arkansas,5,"Grant County",5053,151,50,201,0.7512437811
Yes,Arkansas,5,"Greene County",5055,454,131,585,0.7760683761
Yes,Arkansas,5,"Hempstead County",5057,265,106,371,0.7142857143
Yes,Arkansas,5,"Hot Spring County",5059,370,104,474,0.7805907173
Yes,Arkansas,5,"Howard County",5061,149,67,216,0.6898148148
Yes,Arkansas,5,"Independence County",5063,496,161,657,0.7549467275
Yes,Arkansas,5,"Izard County",5065,228,59,287,0.7944250871
Yes,Arkansas,5,"Jackson County",5067,294,103,397,0.7405541562
Yes,Arkansas,5,"Jefferson County",5069,655,360,1015,0.645320197
Yes,Arkansas,5,"Johnson County",5071,324,119,443,0.7313769752
Yes,Arkansas,5,"Lafayette County",5073,104,66,170,0.6117647059
Yes,Arkansas,5,"Lawrence County",5075,258,94,352,0.7329545455
Yes,Arkansas,5,"Lee County",5077,155,78,233,0.6652360515
Yes,Arkansas,5,"Lincoln County",5079,144,82,226,0.6371681416
Yes,Arkansas,5,"Little River County",5081,119,74,193,0.6165803109
Yes,Arkansas,5,"Logan County",5083,314,89,403,0.7791563275
Yes,Arkansas,5,"Lonoke County",5085,516,183,699,0.7381974249
Yes,Arkansas,5,"Madison County",5087,176,39,215,0.8186046512
Yes,Arkansas,5,"Marion County",5089,194,53,247,0.7854251012
Yes,Arkansas,5,"Miller County",5091,412,180,592,0.6959459459
Yes,Arkansas,5,"Mississippi County",5093,528,247,775,0.6812903226
Yes,Arkansas,5,"Monroe County",5095,145,76,221,0.6561085973
Yes,Arkansas,5,"Montgomery County",5097,99,30,129,0.7674418605
Yes,Arkansas,5,"Nevada County",5099,140,37,177,0.790960452
Yes,Arkansas,5,"Newton County",5101,115,29,144,0.7986111111
Yes,Arkansas,5,"Ouachita County",5103,306,145,451,0.6784922395
Yes,Arkansas,5,"Perry County",5105,115,38,153,0.7516339869
Yes,Arkansas,5,"Phillips County",5107,310,134,444,0.6981981982
Yes,Arkansas,5,"Pike County",5109,148,65,213,0.6948356808
Yes,Arkansas,5,"Poinsett County",5111,423,152,575,0.7356521739
Yes,Arkansas,5,"Polk County",5113,262,69,331,0.7915407855
Yes,Arkansas,5,"Pope County",5115,636,198,834,0.7625899281
Yes,Arkansas,5,"Prairie County",5117,151,50,201,0.7512437811
Yes,Arkansas,5,"Pulaski County",5119,2555,1162,3717,0.6873822976
Yes,Arkansas,5,"Randolph County",5121,244,106,350,0.6971428571
Yes,Arkansas,5,"St. Francis County",5123,356,151,507,0.7021696252
Yes,Arkansas,5,"Saline County",5125,779,266,1045,0.7454545455
Yes,Arkansas,5,"Scott County",5127,155,35,190,0.8157894737
Yes,Arkansas,5,"Searcy County",5129,144,38,182,0.7912087912
Yes,Arkansas,5,"Sebastian County",5131,1035,430,1465,0.7064846416
Yes,Arkansas,5,"Sevier County",5133,153,73,226,0.6769911504
Yes,Arkansas,5,"Sharp County",5135,334,98,432,0.7731481481
Yes,Arkansas,5,"Stone County",5137,245,89,334,0.7335329341
Yes,Arkansas,5,"Union County",5139,466,242,708,0.6581920904
Yes,Arkansas,5,"Van Buren County",5141,243,60,303,0.801980198
Yes,Arkansas,5,"Washington County",5143,1037,332,1369,0.7574872169
Yes,Arkansas,5,"White County",5145,990,317,1307,0.7574598317
Yes,Arkansas,5,"Woodruff County",5147,174,66,240,0.725
Yes,Arkansas,5,"Yell County",5149,263,98,361,0.728531856
Yes,Arkansas,5,,5555,.,0,.,1
Yes,Arkansas,5,,5999,29,13,42,0.6904761905
Yes,California,6,California,6000,0,.,.,0
Yes,California,6,"Alameda County",6001,8541,2515,11056,0.7725217077
Yes,California,6,"Alpine County",6003,.,0,.,1
Yes,California,6,"Amador County",6005,252,73,325,0.7753846154
Yes,California,6,"Butte County",6007,1837,772,2609,0.7041011882
Yes,California,6,"Calaveras County",6009,309,93,402,0.7686567164
Yes,California,6,"Colusa County",6011,179,70,249,0.718875502
Yes,California,6,"Contra Costa County",6013,4317,1418,5735,0.7527462947
Yes,California,6,"Del Norte County",6015,351,108,459,0.7647058824
Yes,California,6,"El Dorado County",6017,751,236,987,0.7608915907
Yes,California,6,"Fresno County",6019,6782,2453,9235,0.7343800758
Yes,California,6,"Glenn County",6021,283,105,388,0.7293814433
Yes,California,6,"Humboldt County",6023,1044,326,1370,0.7620437956
Yes,California,6,"Imperial County",6025,2748,1174,3922,0.7006629271
Yes,California,6,"Inyo County",6027,118,48,166,0.7108433735
Yes,California,6,"Kern County",6029,4777,2015,6792,0.7033274441
Yes,California,6,"Kings County",6031,966,353,1319,0.7323730099
Yes,California,6,"Lake County",6033,916,427,1343,0.6820551005
Yes,California,6,"Lassen County",6035,171,66,237,0.7215189873
Yes,California,6,"Los Angeles County",6037,71571,19797,91368,0.7833267665
Yes,California,6,"Madera County",6039,1004,368,1372,0.7317784257
Yes,California,6,"Marin County",6041,622,247,869,0.7157652474
Yes,California,6,"Mariposa County",6043,122,55,177,0.6892655367
Yes,California,6,"Mendocino County",6045,737,294,1031,0.7148399612
Yes,California,6,"Merced County",6047,2127,798,2925,0.7271794872
Yes,California,6,"Modoc County",6049,104,31,135,0.7703703704
Yes,California,6,"Mono County",6051,.,.,.,0.8
Yes,California,6,"Monterey County",6053,2388,867,3255,0.733640553
Yes,California,6,"Napa County",6055,781,234,1015,0.7694581281
Yes,California,6,"Nevada County",6057,434,173,607,0.7149917628
Yes,California,6,"Orange County",6059,16481,3775,20256,0.813635466
Yes,California,6,"Placer County",6061,1072,343,1415,0.7575971731
Yes,California,6,"Plumas County",6063,188,61,249,0.7550200803
Yes,California,6,"Riverside County",6065,8712,3020,11732,0.7425843846
Yes,California,6,"Sacramento County",6067,8259,2850,11109,0.7434512557
Yes,California,6,"San Benito County",6069,267,112,379,0.7044854881
Yes,California,6,"San Bernardino County",6071,9243,3339,12582,0.734620887
Yes,California,6,"San Diego County",6073,13712,4457,18169,0.7546920579
Yes,California,6,"San Francisco County",6075,8004,1834,9838,0.8135799959
Yes,California,6,"San Joaquin County",6077,4263,1489,5752,0.7411335188
Yes,California,6,"San Luis Obispo County",6079,1337,340,1677,0.7972570066
Yes,California,6,"San Mateo County",6081,2300,606,2906,0.7914659326
Yes,California,6,"Santa Barbara County",6083,1987,630,2617,0.7592663355
Yes,California,6,"Santa Clara County",6085,11454,2636,14090,0.8129169624
Yes,California,6,"Santa Cruz County",6087,1294,451,1745,0.7415472779
Yes,California,6,"Shasta County",6089,1646,537,2183,0.7540082455
Yes,California,6,"Sierra County",6091,.,.,.,0.7714285714
Yes,California,6,"Siskiyou County",6093,479,147,626,0.7651757188
Yes,California,6,"Solano County",6095,2269,705,2974,0.7629455279
Yes,California,6,"Sonoma County",6097,1658,607,2265,0.73200883
Yes,California,6,"Stanislaus County",6099,3663,1330,4993,0.7336270779
Yes,California,6,"Sutter County",6101,962,348,1310,0.734351145
Yes,California,6,"Tehama County",6103,656,207,863,0.7601390498
Yes,California,6,"Trinity County",6105,123,27,150,0.82
Yes,California,6,"Tulare County",6107,3503,1290,4793,0.7308575005
Yes,California,6,"Tuolumne County",6109,375,146,521,0.7197696737
Yes,California,6,"Ventura County",6111,3989,1330,5319,0.7499529987
Yes,California,6,"Yolo County",6113,1120,320,1440,0.7777777778
Yes,California,6,"Yuba County",6115,629,253,882,0.7131519274
Yes,California,6,,6999,113,48,161,0.701863354
Yes,Colorado,8,"Adams County",8001,1125,401,1526,0.7372214941
Yes,Colorado,8,"Alamosa County",8003,106,45,151,0.701986755
Yes,Colorado,8,"Arapahoe County",8005,1267,479,1746,0.7256586483
Yes,Colorado,8,"Archuleta County",8007,58,21,79,0.7341772152
Yes,Colorado,8,"Baca County",8009,47,28,75,0.6266666667
Yes,Colorado,8,"Bent County",8011,56,12,68,0.8235294118
Yes,Colorado,8,"Boulder County",8013,562,218,780,0.7205128205
Yes,Colorado,8,,8014,70,25,95,0.7368421053
Yes,Colorado,8,"Chaffee County",8015,87,26,113,0.7699115044
Yes,Colorado,8,"Cheyenne County",8017,.,.,.,0.7894736842
Yes,Colorado,8,"Clear Creek County",8019,.,.,.,0.7407407407
Yes,Colorado,8,"Conejos County",8021,79,39,118,0.6694915254
Yes,Colorado,8,"Costilla County",8023,38,15,53,0.7169811321
Yes,Colorado,8,"Crowley County",8025,42,15,57,0.7368421053
Yes,Colorado,8,"Custer County",8027,.,.,.,0.75
Yes,Colorado,8,"Delta County",8029,213,49,262,0.8129770992
Yes,Colorado,8,"Denver County",8031,1723,724,2447,0.7041275031
Yes,Colorado,8,"Dolores County",8033,.,.,.,0.7058823529
Yes,Colorado,8,"Douglas County",8035,284,88,372,0.7634408602
Yes,Colorado,8,"Eagle County",8037,33,20,53,0.6226415094
Yes,Colorado,8,"Elbert County",8039,48,12,60,0.8
Yes,Colorado,8,"El Paso County",8041,1864,606,2470,0.7546558704
Yes,Colorado,8,"Fremont County",8043,281,87,368,0.7635869565
Yes,Colorado,8,"Garfield County",8045,182,72,254,0.7165354331
Yes,Colorado,8,"Gilpin County",8047,.,.,.,0.7058823529
Yes,Colorado,8,"Grand County",8049,.,.,.,0.724137931
Yes,Colorado,8,"Gunnison County",8051,34,19,53,0.641509434
Yes,Colorado,8,"Hinsdale County",8053,.,0,.,1
Yes,Colorado,8,"Huerfano County",8055,69,34,103,0.6699029126
Yes,Colorado,8,"Jackson County",8057,.,.,.,0.2
Yes,Colorado,8,"Jefferson County",8059,1115,378,1493,0.7468184863
Yes,Colorado,8,"Kiowa County",8061,.,.,.,0.7391304348
Yes,Colorado,8,"Kit Carson County",8063,42,18,60,0.7
Yes,Colorado,8,"Lake County",8065,.,.,.,0.8571428571
Yes,Colorado,8,"La Plata County",8067,161,57,218,0.7385321101
Yes,Colorado,8,"Larimer County",8069,889,255,1144,0.7770979021
Yes,Colorado,8,"Las Animas County",8071,130,55,185,0.7027027027
Yes,Colorado,8,"Lincoln County",8073,46,13,59,0.7796610169
Yes,Colorado,8,"Logan County",8075,130,48,178,0.7303370787
Yes,Colorado,8,"Mesa County",8077,691,180,871,0.7933409874
Yes,Colorado,8,"Mineral County",8079,.,.,.,0.4
Yes,Colorado,8,"Moffat County",8081,47,17,64,0.734375
Yes,Colorado,8,"Montezuma County",8083,204,51,255,0.8
Yes,Colorado,8,"Montrose County",8085,299,65,364,0.8214285714
Yes,Colorado,8,"Morgan County",8087,214,70,284,0.7535211268
Yes,Colorado,8,"Otero County",8089,209,83,292,0.7157534247
Yes,Colorado,8,"Ouray County",8091,.,.,.,0.6875
Yes,Colorado,8,"Park County",8093,31,15,46,0.6739130435
Yes,Colorado,8,"Phillips County",8095,42,11,53,0.7924528302
Yes,Colorado,8,"Pitkin County",8097,.,.,.,0.625
Yes,Colorado,8,"Prowers County",8099,147,42,189,0.7777777778
Yes,Colorado,8,"Pueblo County",8101,1194,375,1569,0.7609942639
Yes,Colorado,8,"Rio Blanco County",8103,29,16,45,0.6444444444
Yes,Colorado,8,"Rio Grande County",8105,137,43,180,0.7611111111
Yes,Colorado,8,"Routt County",8107,36,15,51,0.7058823529
Yes,Colorado,8,"Saguache County",8109,48,11,59,0.813559322
Yes,Colorado,8,"San Juan County",8111,.,0,.,1
Yes,Colorado,8,"San Miguel County",8113,.,.,.,0.6923076923
Yes,Colorado,8,"Sedgwick County",8115,.,.,.,0.7948717949
Yes,Colorado,8,"Summit County",8117,.,.,.,0.7083333333
Yes,Colorado,8,"Teller County",8119,91,20,111,0.8198198198
Yes,Colorado,8,"Washington County",8121,37,13,50,0.74
Yes,Colorado,8,"Weld County",8123,1067,323,1390,0.7676258993
Yes,Colorado,8,"Yuma County",8125,73,20,93,0.7849462366
Yes,Colorado,8,,8999,.,.,.,0.7142857143
Yes,Connecticut,9,"Fairfield County",9001,5908,1611,7519,0.7857427849
Yes,Connecticut,9,"Hartford County",9003,8198,1973,10171,0.8060171075
Yes,Connecticut,9,"Litchfield County",9005,1822,400,2222,0.8199819982
Yes,Connecticut,9,"Middlesex County",9007,1343,284,1627,0.8254456054
Yes,Connecticut,9,"New Haven County",9009,8000,2232,10232,0.7818608288
Yes,Connecticut,9,"New London County",9011,2850,662,3512,0.8115034169
Yes,Connecticut,9,"Tolland County",9013,1069,204,1273,0.8397486253
Yes,Connecticut,9,"Windham County",9015,1520,289,1809,0.8402432283
Yes,Connecticut,9,,9999,.,.,.,0.8148148148
Yes,Delaware,10,"Kent County",10001,1555,455,2010,0.7736318408
Yes,Delaware,10,"New Castle County",10003,2918,964,3882,0.7516743946
Yes,Delaware,10,"Sussex County",10005,2107,629,2736,0.7701023392
Yes,Delaware,10,,10999,.,.,.,0.7692307692
Yes,"District of Columbia",11,"District of Columbia",11001,4681,2018,6699,0.6987610091
Yes,"District of Columbia",11,,11999,.,.,.,0.25
Yes,Florida,12,"Alachua County",12001,1128,481,1609,0.7010565569
Yes,Florida,12,"Baker County",12003,205,56,261,0.785440613
Yes,Florida,12,"Bay County",12005,1224,454,1678,0.7294398093
Yes,Florida,12,"Bradford County",12007,227,113,340,0.6676470588
Yes,Florida,12,"Brevard County",12009,3004,1096,4100,0.7326829268
Yes,Florida,12,"Broward County",12011,8231,3028,11259,0.7310595968
Yes,Florida,12,"Calhoun County",12013,186,59,245,0.7591836735
Yes,Florida,12,"Charlotte County",12015,1117,357,1474,0.7578018996
Yes,Florida,12,"Citrus County",12017,1220,385,1605,0.7601246106
Yes,Florida,12,"Clay County",12019,857,349,1206,0.7106135987
Yes,Florida,12,"Collier County",12021,1460,485,1945,0.7506426735
Yes,Florida,12,"Columbia County",12023,602,258,860,0.7
Yes,Florida,12,"DeSoto County",12027,319,102,421,0.757719715
Yes,Florida,12,"Dixie County",12029,191,75,266,0.7180451128
Yes,Florida,12,"Duval County",12031,5095,2360,7455,0.683433937
Yes,Florida,12,"Escambia County",12033,2096,872,2968,0.7061994609
Yes,Florida,12,"Flagler County",12035,499,145,644,0.7748447205
Yes,Florida,12,"Franklin County",12037,117,37,154,0.7597402597
Yes,Florida,12,"Gadsden County",12039,402,163,565,0.7115044248
Yes,Florida,12,"Gilchrist County",12041,148,53,201,0.736318408
Yes,Florida,12,"Glades County",12043,78,39,117,0.6666666667
Yes,Florida,12,"Gulf County",12045,158,78,236,0.6694915254
Yes,Florida,12,"Hamilton County",12047,159,62,221,0.7194570136
Yes,Florida,12,"Hardee County",12049,274,82,356,0.7696629213
Yes,Florida,12,"Hendry County",12051,376,145,521,0.7216890595
Yes,Florida,12,"Hernando County",12053,1082,319,1401,0.7723054961
Yes,Florida,12,"Highlands County",12055,990,382,1372,0.721574344
Yes,Florida,12,"Hillsborough County",12057,6667,2198,8865,0.7520586576
Yes,Florida,12,"Holmes County",12059,268,94,362,0.7403314917
Yes,Florida,12,"Indian River County",12061,872,323,1195,0.729707113
Yes,Florida,12,"Jackson County",12063,531,199,730,0.7273972603
Yes,Florida,12,"Jefferson County",12065,146,63,209,0.6985645933
Yes,Florida,12,"Lafayette County",12067,58,20,78,0.7435897436
Yes,Florida,12,"Lake County",12069,1962,639,2601,0.7543252595
Yes,Florida,12,"Lee County",12071,3831,1256,5087,0.7530961274
Yes,Florida,12,"Leon County",12073,890,421,1311,0.6788710908
Yes,Florida,12,"Levy County",12075,461,169,630,0.7317460317
Yes,Florida,12,"Liberty County",12077,81,27,108,0.75
Yes,Florida,12,"Madison County",12079,209,114,323,0.6470588235
Yes,Florida,12,"Manatee County",12081,1569,553,2122,0.7393967955
Yes,Florida,12,"Marion County",12083,2774,939,3713,0.747104767
Yes,Florida,12,"Martin County",12085,518,166,684,0.7573099415
Yes,Florida,12,,12086,25542,6925,32467,0.786706502
Yes,Florida,12,"Monroe County",12087,435,123,558,0.7795698925
Yes,Florida,12,"Nassau County",12089,416,148,564,0.7375886525
Yes,Florida,12,"Okaloosa County",12091,829,371,1200,0.6908333333
Yes,Florida,12,"Okeechobee County",12093,360,174,534,0.6741573034
Yes,Florida,12,"Orange County",12095,5062,2166,7228,0.7003320421
Yes,Florida,12,"Osceola County",12097,1691,696,2387,0.7084206116
Yes,Florida,12,"Palm Beach County",12099,5601,2138,7739,0.7237369169
Yes,Florida,12,"Pasco County",12101,2992,928,3920,0.7632653061
Yes,Florida,12,"Pinellas County",12103,5423,1799,7222,0.7509000277
Yes,Florida,12,"Polk County",12105,3828,1421,5249,0.729281768
Yes,Florida,12,"Putnam County",12107,845,326,1171,0.7216054654
Yes,Florida,12,"St. Johns County",12109,758,264,1022,0.7416829746
Yes,Florida,12,"St. Lucie County",12111,1739,714,2453,0.7089278435
Yes,Florida,12,"Santa Rosa County",12113,860,293,1153,0.7458803122
Yes,Florida,12,"Sarasota County",12115,2134,657,2791,0.7646005016
Yes,Florida,12,"Seminole County",12117,1661,661,2322,0.7153316107
Yes,Florida,12,"Sumter County",12119,557,185,742,0.7506738544
Yes,Florida,12,"Suwannee County",12121,474,213,687,0.6899563319
Yes,Florida,12,"Taylor County",12123,206,93,299,0.6889632107
Yes,Florida,12,"Union County",12125,82,37,119,0.6890756303
Yes,Florida,12,"Volusia County",12127,2764,926,3690,0.7490514905
Yes,Florida,12,"Wakulla County",12129,152,38,190,0.8
Yes,Florida,12,"Walton County",12131,453,162,615,0.7365853659
Yes,Florida,12,"Washington County",12133,340,118,458,0.7423580786
Yes,Florida,12,,12999,83,43,126,0.6587301587
Yes,Georgia,13,"Appling County",13001,219,91,310,0.7064516129
Yes,Georgia,13,"Atkinson County",13003,124,41,165,0.7515151515
Yes,Georgia,13,"Bacon County",13005,160,51,211,0.7582938389
Yes,Georgia,13,"Baker County",13007,41,17,58,0.7068965517
Yes,Georgia,13,"Baldwin County",13009,359,148,507,0.708086785
Yes,Georgia,13,"Banks County",13011,205,61,266,0.7706766917
Yes,Georgia,13,"Barrow County",13013,539,148,687,0.7845705968
Yes,Georgia,13,"Bartow County",13015,822,276,1098,0.7486338798
Yes,Georgia,13,"Ben Hill County",13017,264,102,366,0.7213114754
Yes,Georgia,13,"Berrien County",13019,228,94,322,0.7080745342
Yes,Georgia,13,"Bibb County",13021,1381,679,2060,0.6703883495
Yes,Georgia,13,"Bleckley County",13023,134,53,187,0.7165775401
Yes,Georgia,13,"Brantley County",13025,183,73,256,0.71484375
Yes,Georgia,13,"Brooks County",13027,260,110,370,0.7027027027
Yes,Georgia,13,"Bryan County",13029,152,56,208,0.7307692308
Yes,Georgia,13,"Bulloch County",13031,541,208,749,0.7222963952
Yes,Georgia,13,"Burke County",13033,319,101,420,0.7595238095
Yes,Georgia,13,"Butts County",13035,188,77,265,0.7094339623
Yes,Georgia,13,"Calhoun County",13037,87,24,111,0.7837837838
Yes,Georgia,13,"Camden County",13039,230,83,313,0.7348242812
Yes,Georgia,13,"Candler County",13043,144,42,186,0.7741935484
Yes,Georgia,13,"Carroll County",13045,888,308,1196,0.7424749164
Yes,Georgia,13,"Catoosa County",13047,505,162,667,0.7571214393
Yes,Georgia,13,"Charlton County",13049,141,54,195,0.7230769231
Yes,Georgia,13,"Chatham County",13051,1214,545,1759,0.6901648664
Yes,Georgia,13,"Chattahoochee County",13053,35,13,48,0.7291666667
Yes,Georgia,13,"Chattooga County",13055,388,107,495,0.7838383838
Yes,Georgia,13,"Cherokee County",13057,596,217,813,0.7330873309
Yes,Georgia,13,"Clarke County",13059,616,228,844,0.7298578199
Yes,Georgia,13,"Clay County",13061,36,25,61,0.5901639344
Yes,Georgia,13,"Clayton County",13063,1250,619,1869,0.6688068486
Yes,Georgia,13,"Clinch County",13065,128,62,190,0.6736842105
Yes,Georgia,13,"Cobb County",13067,1791,763,2554,0.7012529366
Yes,Georgia,13,"Coffee County",13069,616,249,865,0.7121387283
Yes,Georgia,13,"Colquitt County",13071,676,259,935,0.7229946524
Yes,Georgia,13,"Columbia County",13073,404,115,519,0.7784200385
Yes,Georgia,13,"Cook County",13075,263,83,346,0.7601156069
Yes,Georgia,13,"Coweta County",13077,534,204,738,0.7235772358
Yes,Georgia,13,"Crawford County",13079,138,27,165,0.8363636364
Yes,Georgia,13,"Crisp County",13081,273,120,393,0.6946564885
Yes,Georgia,13,"Dade County",13083,169,55,224,0.7544642857
Yes,Georgia,13,"Dawson County",13085,163,55,218,0.747706422
Yes,Georgia,13,"Decatur County",13087,355,157,512,0.693359375
Yes,Georgia,13,"DeKalb County",13089,2811,1134,3945,0.7125475285
Yes,Georgia,13,"Dodge County",13091,336,104,440,0.7636363636
Yes,Georgia,13,"Dooly County",13093,124,56,180,0.6888888889
Yes,Georgia,13,"Dougherty County",13095,883,372,1255,0.7035856574
Yes,Georgia,13,"Douglas County",13097,686,261,947,0.7243928194
Yes,Georgia,13,"Early County",13099,176,53,229,0.768558952
Yes,Georgia,13,"Echols County",13101,.,.,.,0.8703703704
Yes,Georgia,13,"Effingham County",13103,292,79,371,0.7870619946
Yes,Georgia,13,"Elbert County",13105,274,104,378,0.7248677249
Yes,Georgia,13,"Emanuel County",13107,330,127,457,0.7221006565
Yes,Georgia,13,"Evans County",13109,129,54,183,0.7049180328
Yes,Georgia,13,"Fannin County",13111,282,78,360,0.7833333333
Yes,Georgia,13,"Fayette County",13113,275,96,371,0.7412398922
Yes,Georgia,13,"Floyd County",13115,1004,392,1396,0.7191977077
Yes,Georgia,13,"Forsyth County",13117,416,142,558,0.7455197133
Yes,Georgia,13,"Franklin County",13119,306,102,408,0.75
Yes,Georgia,13,"Fulton County",13121,3711,1762,5473,0.6780559108
Yes,Georgia,13,"Gilmer County",13123,335,104,439,0.7630979499
Yes,Georgia,13,"Glascock County",13125,31,16,47,0.6595744681
Yes,Georgia,13,"Glynn County",13127,535,212,747,0.7161981258
Yes,Georgia,13,"Gordon County",13129,652,225,877,0.7434435576
Yes,Georgia,13,"Grady County",13131,324,120,444,0.7297297297
Yes,Georgia,13,"Greene County",13133,175,55,230,0.7608695652
Yes,Georgia,13,"Gwinnett County",13135,2532,908,3440,0.7360465116
Yes,Georgia,13,"Habersham County",13137,442,135,577,0.7660311958
Yes,Georgia,13,"Hall County",13139,1132,415,1547,0.7317388494
Yes,Georgia,13,"Hancock County",13141,134,62,196,0.6836734694
Yes,Georgia,13,"Haralson County",13143,331,132,463,0.7149028078
Yes,Georgia,13,"Harris County",13145,175,52,227,0.7709251101
Yes,Georgia,13,"Hart County",13147,325,100,425,0.7647058824
Yes,Georgia,13,"Heard County",13149,121,48,169,0.7159763314
Yes,Georgia,13,"Henry County",13151,871,405,1276,0.6826018809
Yes,Georgia,13,"Houston County",13153,857,346,1203,0.7123857024
Yes,Georgia,13,"Irwin County",13155,127,54,181,0.7016574586
Yes,Georgia,13,"Jackson County",13157,550,164,714,0.7703081232
Yes,Georgia,13,"Jasper County",13159,133,45,178,0.7471910112
Yes,Georgia,13,"Jeff Davis County",13161,212,84,296,0.7162162162
Yes,Georgia,13,"Jefferson County",13163,228,112,340,0.6705882353
Yes,Georgia,13,"Jenkins County",13165,127,65,192,0.6614583333
Yes,Georgia,13,"Johnson County",13167,147,61,208,0.7067307692
Yes,Georgia,13,"Jones County",13169,204,100,304,0.6710526316
Yes,Georgia,13,"Lamar County",13171,163,65,228,0.7149122807
Yes,Georgia,13,"Lanier County",13173,167,39,206,0.8106796117
Yes,Georgia,13,"Laurens County",13175,612,280,892,0.6860986547
Yes,Georgia,13,"Lee County",13177,138,59,197,0.7005076142
Yes,Georgia,13,"Liberty County",13179,245,109,354,0.6920903955
Yes,Georgia,13,"Lincoln County",13181,93,27,120,0.775
Yes,Georgia,13,"Long County",13183,95,41,136,0.6985294118
Yes,Georgia,13,"Lowndes County",13185,985,385,1370,0.7189781022
Yes,Georgia,13,"Lumpkin County",13187,313,95,408,0.7671568627
Yes,Georgia,13,"McDuffie County",13189,227,80,307,0.7394136808
Yes,Georgia,13,"McIntosh County",13191,143,59,202,0.7079207921
Yes,Georgia,13,"Macon County",13193,178,66,244,0.7295081967
Yes,Georgia,13,"Madison County",13195,304,81,385,0.7896103896
Yes,Georgia,13,"Marion County",13197,94,35,129,0.7286821705
Yes,Georgia,13,"Meriwether County",13199,283,100,383,0.7389033943
Yes,Georgia,13,"Miller County",13201,78,34,112,0.6964285714
Yes,Georgia,13,"Mitchell County",13205,302,135,437,0.6910755149
Yes,Georgia,13,"Monroe County",13207,217,83,300,0.7233333333
Yes,Georgia,13,"Montgomery County",13209,130,39,169,0.7692307692
Yes,Georgia,13,"Morgan County",13211,167,59,226,0.7389380531
Yes,Georgia,13,"Murray County",13213,585,201,786,0.7442748092
Yes,Georgia,13,"Muscogee County",13215,1342,585,1927,0.6964193046
Yes,Georgia,13,"Newton County",13217,685,281,966,0.7091097308
Yes,Georgia,13,"Oconee County",13219,119,35,154,0.7727272727
Yes,Georgia,13,"Oglethorpe County",13221,151,34,185,0.8162162162
Yes,Georgia,13,"Paulding County",13223,672,218,890,0.7550561798
Yes,Georgia,13,"Peach County",13225,292,123,415,0.7036144578
Yes,Georgia,13,"Pickens County",13227,300,94,394,0.7614213198
Yes,Georgia,13,"Pierce County",13229,270,99,369,0.7317073171
Yes,Georgia,13,"Pike County",13231,113,42,155,0.7290322581
Yes,Georgia,13,"Polk County",13233,473,228,701,0.6747503566
Yes,Georgia,13,"Pulaski County",13235,116,43,159,0.7295597484
Yes,Georgia,13,"Putnam County",13237,172,76,248,0.6935483871
Yes,Georgia,13,"Quitman County",13239,42,20,62,0.6774193548
Yes,Georgia,13,"Rabun County",13241,254,62,316,0.8037974684
Yes,Georgia,13,"Randolph County",13243,95,38,133,0.7142857143
Yes,Georgia,13,"Richmond County",13245,1297,562,1859,0.6976869285
Yes,Georgia,13,"Rockdale County",13247,415,209,624,0.6650641026
Yes,Georgia,13,"Schley County",13249,42,14,56,0.75
Yes,Georgia,13,"Screven County",13251,217,77,294,0.7380952381
Yes,Georgia,13,"Seminole County",13253,145,49,194,0.7474226804
Yes,Georgia,13,"Spalding County",13255,557,270,827,0.6735187424
Yes,Georgia,13,"Stephens County",13257,390,151,541,0.7208872458
Yes,Georgia,13,"Stewart County",13259,90,33,123,0.7317073171
Yes,Georgia,13,"Sumter County",13261,375,106,481,0.7796257796
Yes,Georgia,13,"Talbot County",13263,90,28,118,0.7627118644
Yes,Georgia,13,"Taliaferro County",13265,.,.,.,0.8285714286
Yes,Georgia,13,"Tattnall County",13267,233,86,319,0.7304075235
Yes,Georgia,13,"Taylor County",13269,142,49,191,0.7434554974
Yes,Georgia,13,"Telfair County",13271,208,67,275,0.7563636364
Yes,Georgia,13,"Terrell County",13273,121,54,175,0.6914285714
Yes,Georgia,13,"Thomas County",13275,522,245,767,0.6805736636
Yes,Georgia,13,"Tift County",13277,402,175,577,0.6967071057
Yes,Georgia,13,"Toombs County",13279,378,123,501,0.754491018
Yes,Georgia,13,"Towns County",13281,152,45,197,0.7715736041
Yes,Georgia,13,"Treutlen County",13283,116,48,164,0.7073170732
Yes,Georgia,13,"Troup County",13285,680,281,961,0.7075962539
Yes,Georgia,13,"Turner County",13287,111,47,158,0.7025316456
Yes,Georgia,13,"Twiggs County",13289,116,57,173,0.6705202312
Yes,Georgia,13,"Union County",13291,276,75,351,0.7863247863
Yes,Georgia,13,"Upson County",13293,339,159,498,0.6807228916
Yes,Georgia,13,"Walker County",13295,759,248,1007,0.7537239325
Yes,Georgia,13,"Walton County",13297,592,224,816,0.7254901961
Yes,Georgia,13,"Ware County",13299,542,253,795,0.6817610063
Yes,Georgia,13,"Warren County",13301,101,37,138,0.731884058
Yes,Georgia,13,"Washington County",13303,239,111,350,0.6828571429
Yes,Georgia,13,"Wayne County",13305,300,125,425,0.7058823529
Yes,Georgia,13,"Webster County",13307,32,11,43,0.7441860465
Yes,Georgia,13,"Wheeler County",13309,99,33,132,0.75
Yes,Georgia,13,"White County",13311,343,121,464,0.7392241379
Yes,Georgia,13,"Whitfield County",13313,858,354,1212,0.7079207921
Yes,Georgia,13,"Wilcox County",13315,120,43,163,0.736196319
Yes,Georgia,13,"Wilkes County",13317,170,57,227,0.7488986784
Yes,Georgia,13,"Wilkinson County",13319,121,47,168,0.7202380952
Yes,Georgia,13,"Worth County",13321,242,72,314,0.7707006369
Yes,Georgia,13,,13999,56,24,80,0.7
Yes,Hawaii,15,"Hawaii County",15001,1137,331,1468,0.7745231608
Yes,Hawaii,15,"Honolulu County",15003,2487,840,3327,0.7475202885
Yes,Hawaii,15,"Kauai County",15007,251,86,337,0.7448071217
Yes,Hawaii,15,"Maui County",15009,480,172,652,0.736196319
Yes,Hawaii,15,,15999,0,.,.,0
Yes,Idaho,16,"Ada County",16001,1074,334,1408,0.7627840909
Yes,Idaho,16,"Adams County",16003,20,15,35,0.5714285714
Yes,Idaho,16,"Bannock County",16005,375,147,522,0.7183908046
Yes,Idaho,16,"Bear Lake County",16007,42,13,55,0.7636363636
Yes,Idaho,16,"Benewah County",16009,79,24,103,0.7669902913
Yes,Idaho,16,"Bingham County",16011,188,81,269,0.6988847584
Yes,Idaho,16,"Blaine County",16013,32,15,47,0.6808510638
Yes,Idaho,16,"Boise County",16015,.,.,.,0.8139534884
Yes,Idaho,16,"Bonner County",16017,238,64,302,0.7880794702
Yes,Idaho,16,"Bonneville County",16019,466,155,621,0.7504025765
Yes,Idaho,16,"Boundary County",16021,82,22,104,0.7884615385
Yes,Idaho,16,"Butte County",16023,.,.,.,0.7083333333
Yes,Idaho,16,"Camas County",16025,.,.,.,0.6
Yes,Idaho,16,"Canyon County",16027,918,298,1216,0.7549342105
Yes,Idaho,16,"Caribou County",16029,.,.,.,0.8157894737
Yes,Idaho,16,"Cassia County",16031,114,39,153,0.7450980392
Yes,Idaho,16,"Clark County",16033,.,0,.,1
Yes,Idaho,16,"Clearwater County",16035,81,24,105,0.7714285714
Yes,Idaho,16,"Custer County",16037,.,.,.,0.7368421053
Yes,Idaho,16,"Elmore County",16039,170,55,225,0.7555555556
Yes,Idaho,16,"Franklin County",16041,41,14,55,0.7454545455
Yes,Idaho,16,"Fremont County",16043,65,20,85,0.7647058824
Yes,Idaho,16,"Gem County",16045,108,20,128,0.84375
Yes,Idaho,16,"Gooding County",16047,86,33,119,0.7226890756
Yes,Idaho,16,"Idaho County",16049,135,43,178,0.7584269663
Yes,Idaho,16,"Jefferson County",16051,92,37,129,0.7131782946
Yes,Idaho,16,"Jerome County",16053,89,35,124,0.7177419355
Yes,Idaho,16,"Kootenai County",16055,791,242,1033,0.7657308809
Yes,Idaho,16,"Latah County",16057,110,40,150,0.7333333333
Yes,Idaho,16,"Lemhi County",16059,64,21,85,0.7529411765
Yes,Idaho,16,"Lewis County",16061,50,21,71,0.7042253521
Yes,Idaho,16,"Lincoln County",16063,.,.,.,0.6428571429
Yes,Idaho,16,"Madison County",16065,59,18,77,0.7662337662
Yes,Idaho,16,"Minidoka County",16067,111,35,146,0.7602739726
Yes,Idaho,16,"Nez Perce County",16069,256,87,343,0.7463556851
Yes,Idaho,16,"Oneida County",16071,.,.,.,0.7931034483
Yes,Idaho,16,"Owyhee County",16073,65,24,89,0.7303370787
Yes,Idaho,16,"Payette County",16075,179,34,213,0.8403755869
Yes,Idaho,16,"Power County",16077,39,24,63,0.619047619
Yes,Idaho,16,"Shoshone County",16079,158,52,210,0.7523809524
Yes,Idaho,16,"Teton County",16081,.,.,.,0.7727272727
Yes,Idaho,16,"Twin Falls County",16083,484,128,612,0.7908496732
Yes,Idaho,16,"Valley County",16085,33,11,44,0.75
Yes,Idaho,16,"Washington County",16087,87,40,127,0.6850393701
Yes,Idaho,16,,16999,.,.,.,0.4
Yes,Illinois,17,"Adams County",17001,620,180,800,0.775
Yes,Illinois,17,"Alexander County",17003,108,42,150,0.72
Yes,Illinois,17,"Bond County",17005,179,32,211,0.8483412322
Yes,Illinois,17,"Boone County",17007,263,74,337,0.7804154303
Yes,Illinois,17,"Brown County",17009,66,13,79,0.835443038
Yes,Illinois,17,"Bureau County",17011,267,66,333,0.8018018018
Yes,Illinois,17,"Calhoun County",17013,65,16,81,0.8024691358
Yes,Illinois,17,"Carroll County",17015,152,34,186,0.8172043011
Yes,Illinois,17,"Cass County",17017,152,38,190,0.8
Yes,Illinois,17,"Champaign County",17019,913,301,1214,0.7520593081
Yes,Illinois,17,"Christian County",17021,321,102,423,0.7588652482
Yes,Illinois,17,"Clark County",17023,174,71,245,0.7102040816
Yes,Illinois,17,"Clay County",17025,214,35,249,0.859437751
Yes,Illinois,17,"Clinton County",17027,282,57,339,0.8318584071
Yes,Illinois,17,"Coles County",17029,593,134,727,0.8156808803
Yes,Illinois,17,"Cook County",17031,35613,13025,48638,0.7322052716
Yes,Illinois,17,"Crawford County",17033,195,50,245,0.7959183673
Yes,Illinois,17,"Cumberland County",17035,131,26,157,0.8343949045
Yes,Illinois,17,"DeKalb County",17037,475,157,632,0.7515822785
Yes,Illinois,17,"De Witt County",17039,150,28,178,0.8426966292
Yes,Illinois,17,"Douglas County",17041,162,40,202,0.801980198
Yes,Illinois,17,"DuPage County",17043,3384,1036,4420,0.7656108597
Yes,Illinois,17,"Edgar County",17045,273,64,337,0.8100890208
Yes,Illinois,17,"Edwards County",17047,52,13,65,0.8
Yes,Illinois,17,"Effingham County",17049,310,72,382,0.8115183246
Yes,Illinois,17,"Fayette County",17051,264,65,329,0.8024316109
Yes,Illinois,17,"Ford County",17053,119,44,163,0.7300613497
Yes,Illinois,17,"Franklin County",17055,676,141,817,0.8274173807
Yes,Illinois,17,"Fulton County",17057,280,75,355,0.7887323944
Yes,Illinois,17,"Gallatin County",17059,81,30,111,0.7297297297
Yes,Illinois,17,"Greene County",17061,176,58,234,0.7521367521
Yes,Illinois,17,"Grundy County",17063,213,71,284,0.75
Yes,Illinois,17,"Hamilton County",17065,129,21,150,0.86
Yes,Illinois,17,"Hancock County",17067,185,49,234,0.7905982906
Yes,Illinois,17,"Hardin County",17069,75,21,96,0.78125
Yes,Illinois,17,"Henderson County",17071,65,17,82,0.7926829268
Yes,Illinois,17,"Henry County",17073,317,60,377,0.8408488064
Yes,Illinois,17,"Iroquois County",17075,311,67,378,0.8227513228
Yes,Illinois,17,"Jackson County",17077,496,165,661,0.7503782148
Yes,Illinois,17,"Jasper County",17079,111,23,134,0.828358209
Yes,Illinois,17,"Jefferson County",17081,491,134,625,0.7856
Yes,Illinois,17,"Jersey County",17083,226,68,294,0.768707483
Yes,Illinois,17,"Jo Daviess County",17085,76,22,98,0.7755102041
Yes,Illinois,17,"Johnson County",17087,122,41,163,0.7484662577
Yes,Illinois,17,"Kane County",17089,2201,719,2920,0.7537671233
Yes,Illinois,17,"Kankakee County",17091,929,310,1239,0.7497982244
Yes,Illinois,17,"Kendall County",17093,386,122,508,0.7598425197
Yes,Illinois,17,"Knox County",17095,434,114,548,0.7919708029
Yes,Illinois,17,"Lake County",17097,2944,973,3917,0.7515956089
Yes,Illinois,17,"La Salle County",17099,844,207,1051,0.8030447193
Yes,Illinois,17,"Lawrence County",17101,201,59,260,0.7730769231
Yes,Illinois,17,"Lee County",17103,307,94,401,0.7655860349
Yes,Illinois,17,"Livingston County",17105,305,82,387,0.7881136951
Yes,Illinois,17,"Logan County",17107,268,60,328,0.8170731707
Yes,Illinois,17,"McDonough County",17109,247,56,303,0.8151815182
Yes,Illinois,17,"McHenry County",17111,1251,382,1633,0.7660747091
Yes,Illinois,17,"McLean County",17113,714,205,919,0.7769314472
Yes,Illinois,17,"Macon County",17115,1179,376,1555,0.7581993569
Yes,Illinois,17,"Macoupin County",17117,464,118,582,0.7972508591
Yes,Illinois,17,"Madison County",17119,1609,531,2140,0.7518691589
Yes,Illinois,17,"Marion County",17121,660,195,855,0.7719298246
Yes,Illinois,17,"Marshall County",17123,79,23,102,0.7745098039
Yes,Illinois,17,"Mason County",17125,140,31,171,0.8187134503
Yes,Illinois,17,"Massac County",17127,240,64,304,0.7894736842
Yes,Illinois,17,"Menard County",17129,109,23,132,0.8257575758
Yes,Illinois,17,"Mercer County",17131,105,17,122,0.8606557377
Yes,Illinois,17,"Monroe County",17133,105,30,135,0.7777777778
Yes,Illinois,17,"Montgomery County",17135,371,103,474,0.7827004219
Yes,Illinois,17,"Morgan County",17137,376,104,480,0.7833333333
Yes,Illinois,17,"Moultrie County",17139,146,36,182,0.8021978022
Yes,Illinois,17,"Ogle County",17141,366,84,450,0.8133333333
Yes,Illinois,17,"Peoria County",17143,1210,348,1558,0.7766367137
Yes,Illinois,17,"Perry County",17145,201,72,273,0.7362637363
Yes,Illinois,17,"Piatt County",17147,92,17,109,0.8440366972
Yes,Illinois,17,"Pike County",17149,238,55,293,0.8122866894
Yes,Illinois,17,"Pope County",17151,45,15,60,0.75
Yes,Illinois,17,"Pulaski County",17153,92,43,135,0.6814814815
Yes,Illinois,17,"Putnam County",17155,.,.,.,0.825
Yes,Illinois,17,"Randolph County",17157,298,82,380,0.7842105263
Yes,Illinois,17,"Richland County",17159,227,61,288,0.7881944444
Yes,Illinois,17,"Rock Island County",17161,993,294,1287,0.7715617716
Yes,Illinois,17,"St. Clair County",17163,1855,725,2580,0.7189922481
Yes,Illinois,17,"Saline County",17165,396,117,513,0.7719298246
Yes,Illinois,17,"Sangamon County",17167,1596,502,2098,0.7607244995
Yes,Illinois,17,"Schuyler County",17169,78,26,104,0.75
Yes,Illinois,17,"Scott County",17171,59,13,72,0.8194444444
Yes,Illinois,17,"Shelby County",17173,243,73,316,0.7689873418
Yes,Illinois,17,"Stark County",17175,38,17,55,0.6909090909
Yes,Illinois,17,"Stephenson County",17177,402,97,499,0.8056112224
Yes,Illinois,17,"Tazewell County",17179,721,165,886,0.8137697517
Yes,Illinois,17,"Union County",17181,298,68,366,0.8142076503
Yes,Illinois,17,"Vermilion County",17183,796,255,1051,0.7573739296
Yes,Illinois,17,"Wabash County",17185,117,34,151,0.7748344371
Yes,Illinois,17,"Warren County",17187,166,30,196,0.8469387755
Yes,Illinois,17,"Washington County",17189,127,39,166,0.765060241
Yes,Illinois,17,"Wayne County",17191,196,67,263,0.7452471483
Yes,Illinois,17,"White County",17193,206,50,256,0.8046875
Yes,Illinois,17,"Whiteside County",17195,544,146,690,0.7884057971
Yes,Illinois,17,"Will County",17197,2589,890,3479,0.7441793619
Yes,Illinois,17,"Williamson County",17199,815,271,1086,0.7504604052
Yes,Illinois,17,"Winnebago County",17201,2226,674,2900,0.7675862069
Yes,Illinois,17,"Woodford County",17203,170,35,205,0.8292682927
Yes,Illinois,17,,17999,45,25,70,0.6428571429
Yes,Indiana,18,"Adams County",18001,153,25,178,0.8595505618
Yes,Indiana,18,"Allen County",18003,1895,655,2550,0.7431372549
Yes,Indiana,18,"Bartholomew County",18005,524,158,682,0.7683284457
Yes,Indiana,18,"Benton County",18007,87,27,114,0.7631578947
Yes,Indiana,18,"Blackford County",18009,164,33,197,0.8324873096
Yes,Indiana,18,"Boone County",18011,286,103,389,0.735218509
Yes,Indiana,18,"Brown County",18013,118,19,137,0.8613138686
Yes,Indiana,18,"Carroll County",18015,136,40,176,0.7727272727
Yes,Indiana,18,"Cass County",18017,331,78,409,0.8092909535
Yes,Indiana,18,"Clark County",18019,959,341,1300,0.7376923077
Yes,Indiana,18,"Clay County",18021,295,102,397,0.7430730479
Yes,Indiana,18,"Clinton County",18023,267,56,323,0.826625387
Yes,Indiana,18,"Crawford County",18025,146,34,180,0.8111111111
Yes,Indiana,18,"Daviess County",18027,295,80,375,0.7866666667
Yes,Indiana,18,"Dearborn County",18029,309,99,408,0.7573529412
Yes,Indiana,18,"Decatur County",18031,213,50,263,0.8098859316
Yes,Indiana,18,"De Kalb County",18033,249,86,335,0.7432835821
Yes,Indiana,18,"Delaware County",18035,1091,335,1426,0.7650771388
Yes,Indiana,18,"Dubois County",18037,269,53,322,0.8354037267
Yes,Indiana,18,"Elkhart County",18039,1168,325,1493,0.7823174816
Yes,Indiana,18,"Fayette County",18041,422,113,535,0.7887850467
Yes,Indiana,18,"Floyd County",18043,646,224,870,0.7425287356
Yes,Indiana,18,"Fountain County",18045,154,54,208,0.7403846154
Yes,Indiana,18,"Franklin County",18047,176,48,224,0.7857142857
Yes,Indiana,18,"Fulton County",18049,165,43,208,0.7932692308
Yes,Indiana,18,"Gibson County",18051,233,94,327,0.7125382263
Yes,Indiana,18,"Grant County",18053,890,230,1120,0.7946428571
Yes,Indiana,18,"Greene County",18055,358,109,467,0.7665952891
Yes,Indiana,18,"Hamilton County",18057,831,198,1029,0.8075801749
Yes,Indiana,18,"Hancock County",18059,388,97,485,0.8
Yes,Indiana,18,"Harrison County",18061,348,96,444,0.7837837838
Yes,Indiana,18,"Hendricks County",18063,537,171,708,0.7584745763
Yes,Indiana,18,"Henry County",18065,559,158,717,0.779637378
Yes,Indiana,18,"Howard County",18067,695,206,901,0.7713651498
Yes,Indiana,18,"Huntington County",18069,242,56,298,0.8120805369
Yes,Indiana,18,"Jackson County",18071,349,96,445,0.7842696629
Yes,Indiana,18,"Jasper County",18073,197,60,257,0.766536965
Yes,Indiana,18,"Jay County",18075,228,55,283,0.8056537102
Yes,Indiana,18,"Jefferson County",18077,332,83,415,0.8
Yes,Indiana,18,"Jennings County",18079,316,89,405,0.7802469136
Yes,Indiana,18,"Johnson County",18081,829,189,1018,0.8143418468
Yes,Indiana,18,"Knox County",18083,487,138,625,0.7792
Yes,Indiana,18,"Kosciusko County",18085,443,131,574,0.7717770035
Yes,Indiana,18,"Lagrange County",18087,158,40,198,0.797979798
Yes,Indiana,18,"Lake County",18089,3435,1297,4732,0.7259087067
Yes,Indiana,18,"La Porte County",18091,999,318,1317,0.7585421412
Yes,Indiana,18,"Lawrence County",18093,472,129,601,0.7853577371
Yes,Indiana,18,"Madison County",18095,1283,343,1626,0.7890528905
Yes,Indiana,18,"Marion County",18097,7210,2414,9624,0.7491687448
Yes,Indiana,18,"Marshall County",18099,346,81,427,0.8103044496
Yes,Indiana,18,"Martin County",18101,105,24,129,0.8139534884
Yes,Indiana,18,"Miami County",18103,362,78,440,0.8227272727
Yes,Indiana,18,"Monroe County",18105,719,191,910,0.7901098901
Yes,Indiana,18,"Montgomery County",18107,293,76,369,0.7940379404
Yes,Indiana,18,"Morgan County",18109,515,147,662,0.7779456193
Yes,Indiana,18,"Newton County",18111,116,31,147,0.7891156463
Yes,Indiana,18,"Noble County",18113,319,75,394,0.8096446701
Yes,Indiana,18,"Ohio County",18115,56,21,77,0.7272727273
Yes,Indiana,18,"Orange County",18117,304,71,375,0.8106666667
Yes,Indiana,18,"Owen County",18119,192,59,251,0.764940239
Yes,Indiana,18,"Parke County",18121,169,45,214,0.7897196262
Yes,Indiana,18,"Perry County",18123,193,58,251,0.7689243028
Yes,Indiana,18,"Pike County",18125,165,23,188,0.8776595745
Yes,Indiana,18,"Porter County",18127,889,262,1151,0.7723718506
Yes,Indiana,18,"Posey County",18129,171,38,209,0.8181818182
Yes,Indiana,18,"Pulaski County",18131,145,39,184,0.7880434783
Yes,Indiana,18,"Putnam County",18133,299,105,404,0.7400990099
Yes,Indiana,18,"Randolph County",18135,267,87,354,0.7542372881
Yes,Indiana,18,"Ripley County",18137,270,79,349,0.7736389685
Yes,Indiana,18,"Rush County",18139,191,52,243,0.7860082305
Yes,Indiana,18,"St. Joseph County",18141,1512,474,1986,0.7613293051
Yes,Indiana,18,"Scott County",18143,362,132,494,0.7327935223
Yes,Indiana,18,"Shelby County",18145,417,148,565,0.7380530973
Yes,Indiana,18,"Spencer County",18147,176,45,221,0.7963800905
Yes,Indiana,18,"Starke County",18149,308,58,366,0.8415300546
Yes,Indiana,18,"Steuben County",18151,231,52,283,0.816254417
Yes,Indiana,18,"Sullivan County",18153,252,72,324,0.7777777778
Yes,Indiana,18,"Switzerland County",18155,121,20,141,0.8581560284
Yes,Indiana,18,"Tippecanoe County",18157,860,265,1125,0.7644444444
Yes,Indiana,18,"Tipton County",18159,116,27,143,0.8111888112
Yes,Indiana,18,"Union County",18161,82,22,104,0.7884615385
Yes,Indiana,18,"Vanderburgh County",18163,1511,475,1986,0.7608257805
Yes,Indiana,18,"Vermillion County",18165,242,73,315,0.7682539683
Yes,Indiana,18,"Vigo County",18167,1467,577,2044,0.7177103718
Yes,Indiana,18,"Wabash County",18169,258,67,325,0.7938461538
Yes,Indiana,18,"Warren County",18171,54,26,80,0.675
Yes,Indiana,18,"Warrick County",18173,365,107,472,0.7733050847
Yes,Indiana,18,"Washington County",18175,363,93,456,0.7960526316
Yes,Indiana,18,"Wayne County",18177,1045,331,1376,0.7594476744
Yes,Indiana,18,"Wells County",18179,155,38,193,0.8031088083
Yes,Indiana,18,"White County",18181,218,52,270,0.8074074074
Yes,Indiana,18,"Whitley County",18183,141,45,186,0.7580645161
Yes,Indiana,18,,18999,41,16,57,0.7192982456
Yes,Iowa,19,"Adair County",19001,62,14,76,0.8157894737
Yes,Iowa,19,"Adams County",19003,.,.,.,0.9772727273
Yes,Iowa,19,"Allamakee County",19005,124,14,138,0.8985507246
Yes,Iowa,19,"Appanoose County",19007,166,47,213,0.779342723
Yes,Iowa,19,"Audubon County",19009,.,.,.,0.8769230769
Yes,Iowa,19,"Benton County",19011,152,24,176,0.8636363636
Yes,Iowa,19,"Black Hawk County",19013,941,203,1144,0.8225524476
Yes,Iowa,19,"Boone County",19015,153,29,182,0.8406593407
Yes,Iowa,19,"Bremer County",19017,94,17,111,0.8468468468
Yes,Iowa,19,"Buchanan County",19019,132,31,163,0.8098159509
Yes,Iowa,19,"Buena Vista County",19021,115,23,138,0.8333333333
Yes,Iowa,19,"Butler County",19023,99,17,116,0.8534482759
Yes,Iowa,19,"Calhoun County",19025,87,22,109,0.7981651376
Yes,Iowa,19,"Carroll County",19027,157,29,186,0.8440860215
Yes,Iowa,19,"Cass County",19029,145,24,169,0.8579881657
Yes,Iowa,19,"Cedar County",19031,65,15,80,0.8125
Yes,Iowa,19,"Cerro Gordo County",19033,454,94,548,0.8284671533
Yes,Iowa,19,"Cherokee County",19035,75,14,89,0.8426966292
Yes,Iowa,19,"Chickasaw County",19037,69,12,81,0.8518518519
Yes,Iowa,19,"Clarke County",19039,98,24,122,0.8032786885
Yes,Iowa,19,"Clay County",19041,156,24,180,0.8666666667
Yes,Iowa,19,"Clayton County",19043,139,17,156,0.891025641
Yes,Iowa,19,"Clinton County",19045,417,108,525,0.7942857143
Yes,Iowa,19,"Crawford County",19047,108,20,128,0.84375
Yes,Iowa,19,"Dallas County",19049,236,53,289,0.8166089965
Yes,Iowa,19,"Davis County",19051,75,13,88,0.8522727273
Yes,Iowa,19,"Decatur County",19053,82,18,100,0.82
Yes,Iowa,19,"Delaware County",19055,84,20,104,0.8076923077
Yes,Iowa,19,"Des Moines County",19057,319,83,402,0.7935323383
Yes,Iowa,19,"Dickinson County",19059,111,16,127,0.874015748
Yes,Iowa,19,"Dubuque County",19061,522,141,663,0.7873303167
Yes,Iowa,19,"Emmet County",19063,78,18,96,0.8125
Yes,Iowa,19,"Fayette County",19065,189,29,218,0.8669724771
Yes,Iowa,19,"Floyd County",19067,130,31,161,0.8074534161
Yes,Iowa,19,"Franklin County",19069,78,18,96,0.8125
Yes,Iowa,19,"Fremont County",19071,90,16,106,0.8490566038
Yes,Iowa,19,"Greene County",19073,67,18,85,0.7882352941
Yes,Iowa,19,"Grundy County",19075,51,13,64,0.796875
Yes,Iowa,19,"Guthrie County",19077,73,11,84,0.869047619
Yes,Iowa,19,"Hamilton County",19079,111,32,143,0.7762237762
Yes,Iowa,19,"Hancock County",19081,69,19,88,0.7840909091
Yes,Iowa,19,"Hardin County",19083,158,27,185,0.8540540541
Yes,Iowa,19,"Harrison County",19085,103,21,124,0.8306451613
Yes,Iowa,19,"Henry County",19087,164,31,195,0.841025641
Yes,Iowa,19,"Howard County",19089,58,16,74,0.7837837838
Yes,Iowa,19,"Humboldt County",19091,68,11,79,0.8607594937
Yes,Iowa,19,"Ida County",19093,39,12,51,0.7647058824
Yes,Iowa,19,"Iowa County",19095,76,17,93,0.8172043011
Yes,Iowa,19,"Jackson County",19097,165,24,189,0.873015873
Yes,Iowa,19,"Jasper County",19099,230,55,285,0.8070175439
Yes,Iowa,19,"Jefferson County",19101,143,30,173,0.8265895954
Yes,Iowa,19,"Johnson County",19103,498,116,614,0.8110749186
Yes,Iowa,19,"Jones County",19105,135,25,160,0.84375
Yes,Iowa,19,"Keokuk County",19107,70,30,100,0.7
Yes,Iowa,19,"Kossuth County",19109,107,12,119,0.8991596639
Yes,Iowa,19,"Lee County",19111,370,84,454,0.8149779736
Yes,Iowa,19,"Linn County",19113,1185,273,1458,0.8127572016
Yes,Iowa,19,"Louisa County",19115,78,22,100,0.78
Yes,Iowa,19,"Lucas County",19117,83,16,99,0.8383838384
Yes,Iowa,19,"Lyon County",19119,39,12,51,0.7647058824
Yes,Iowa,19,"Madison County",19121,63,14,77,0.8181818182
Yes,Iowa,19,"Mahaska County",19123,152,43,195,0.7794871795
Yes,Iowa,19,"Marion County",19125,176,44,220,0.8
Yes,Iowa,19,"Marshall County",19127,329,44,373,0.8820375335
Yes,Iowa,19,"Mills County",19129,108,28,136,0.7941176471
Yes,Iowa,19,"Mitchell County",19131,67,14,81,0.8271604938
Yes,Iowa,19,"Monona County",19133,90,23,113,0.796460177
Yes,Iowa,19,"Monroe County",19135,78,17,95,0.8210526316
Yes,Iowa,19,"Montgomery County",19137,138,26,164,0.8414634146
Yes,Iowa,19,"Muscatine County",19139,280,68,348,0.8045977011
Yes,Iowa,19,O,19141,110,17,127,0.8661417323
Yes,Iowa,19,"Osceola County",19143,37,13,50,0.74
Yes,Iowa,19,"Page County",19145,209,52,261,0.8007662835
Yes,Iowa,19,"Palo Alto County",19147,.,.,.,0.9428571429
Yes,Iowa,19,"Plymouth County",19149,98,20,118,0.8305084746
Yes,Iowa,19,"Pocahontas County",19151,70,17,87,0.8045977011
Yes,Iowa,19,"Polk County",19153,2150,581,2731,0.7872574149
Yes,Iowa,19,"Pottawattamie County",19155,725,156,881,0.8229284904
Yes,Iowa,19,"Poweshiek County",19157,124,26,150,0.8266666667
Yes,Iowa,19,"Ringgold County",19159,.,.,.,0.9178082192
Yes,Iowa,19,"Sac County",19161,81,17,98,0.8265306122
Yes,Iowa,19,"Scott County",19163,999,272,1271,0.7859952793
Yes,Iowa,19,"Shelby County",19165,98,21,119,0.8235294118
Yes,Iowa,19,"Sioux County",19167,128,21,149,0.8590604027
Yes,Iowa,19,"Story County",19169,275,58,333,0.8258258258
Yes,Iowa,19,"Tama County",19171,115,19,134,0.8582089552
Yes,Iowa,19,"Taylor County",19173,59,15,74,0.7972972973
Yes,Iowa,19,"Union County",19175,124,27,151,0.821192053
Yes,Iowa,19,"Van Buren County",19177,66,17,83,0.7951807229
Yes,Iowa,19,"Wapello County",19179,410,136,546,0.7509157509
Yes,Iowa,19,"Warren County",19181,186,50,236,0.7881355932
Yes,Iowa,19,"Washington County",19183,155,40,195,0.7948717949
Yes,Iowa,19,"Wayne County",19185,62,13,75,0.8266666667
Yes,Iowa,19,"Webster County",19187,325,79,404,0.8044554455
Yes,Iowa,19,"Winnebago County",19189,.,.,.,0.9166666667
Yes,Iowa,19,"Winneshiek County",19191,111,23,134,0.828358209
Yes,Iowa,19,"Woodbury County",19193,716,211,927,0.7723840345
Yes,Iowa,19,"Worth County",19195,56,12,68,0.8235294118
Yes,Iowa,19,"Wright County",19197,.,.,.,0.9444444444
Yes,Iowa,19,,19999,.,.,.,0.6666666667
Yes,Kansas,20,"Allen County",20001,148,36,184,0.8043478261
Yes,Kansas,20,"Anderson County",20003,53,20,73,0.7260273973
Yes,Kansas,20,"Atchison County",20005,137,44,181,0.7569060773
Yes,Kansas,20,"Barber County",20007,.,.,.,0.8571428571
Yes,Kansas,20,"Barton County",20009,198,57,255,0.7764705882
Yes,Kansas,20,"Bourbon County",20011,122,36,158,0.7721518987
Yes,Kansas,20,"Brown County",20013,101,30,131,0.7709923664
Yes,Kansas,20,"Butler County",20015,270,50,320,0.84375
Yes,Kansas,20,"Chase County",20017,.,.,.,0.7878787879
Yes,Kansas,20,"Chautauqua County",20019,43,12,55,0.7818181818
Yes,Kansas,20,"Cherokee County",20021,226,66,292,0.7739726027
Yes,Kansas,20,"Cheyenne County",20023,.,.,.,0.7037037037
Yes,Kansas,20,"Clark County",20025,.,.,.,0.84375
Yes,Kansas,20,"Clay County",20027,.,.,.,0.9078947368
Yes,Kansas,20,"Cloud County",20029,96,19,115,0.8347826087
Yes,Kansas,20,"Coffey County",20031,51,24,75,0.68
Yes,Kansas,20,"Comanche County",20033,.,.,.,0.9047619048
Yes,Kansas,20,"Cowley County",20035,256,71,327,0.7828746177
Yes,Kansas,20,"Crawford County",20037,352,113,465,0.7569892473
Yes,Kansas,20,"Decatur County",20039,.,.,.,0.76
Yes,Kansas,20,"Dickinson County",20041,152,31,183,0.8306010929
Yes,Kansas,20,"Doniphan County",20043,.,.,.,0.8823529412
Yes,Kansas,20,"Douglas County",20045,360,94,454,0.7929515419
Yes,Kansas,20,"Edwards County",20047,.,.,.,0.7586206897
Yes,Kansas,20,"Elk County",20049,32,11,43,0.7441860465
Yes,Kansas,20,"Ellis County",20051,171,40,211,0.8104265403
Yes,Kansas,20,"Ellsworth County",20053,38,14,52,0.7307692308
Yes,Kansas,20,"Finney County",20055,177,58,235,0.7531914894
Yes,Kansas,20,"Ford County",20057,176,41,217,0.8110599078
Yes,Kansas,20,"Franklin County",20059,182,46,228,0.798245614
Yes,Kansas,20,"Geary County",20061,122,39,161,0.7577639752
Yes,Kansas,20,"Gove County",20063,.,.,.,0.7272727273
Yes,Kansas,20,"Graham County",20065,.,.,.,0.7419354839
Yes,Kansas,20,"Grant County",20067,36,18,54,0.6666666667
Yes,Kansas,20,"Gray County",20069,.,.,.,0.8444444444
Yes,Kansas,20,"Greeley County",20071,.,.,.,0.9333333333
Yes,Kansas,20,"Greenwood County",20073,86,23,109,0.7889908257
Yes,Kansas,20,"Hamilton County",20075,.,.,.,0.6153846154
Yes,Kansas,20,"Harper County",20077,.,.,.,0.8181818182
Yes,Kansas,20,"Harvey County",20079,213,54,267,0.797752809
Yes,Kansas,20,"Haskell County",20081,.,.,.,0.78125
Yes,Kansas,20,"Hodgeman County",20083,.,.,.,0.875
Yes,Kansas,20,"Jackson County",20085,67,21,88,0.7613636364
Yes,Kansas,20,"Jefferson County",20087,103,23,126,0.8174603175
Yes,Kansas,20,"Jewell County",20089,.,.,.,0.8604651163
Yes,Kansas,20,"Johnson County",20091,1150,335,1485,0.7744107744
Yes,Kansas,20,"Kearny County",20093,.,.,.,0.8928571429
Yes,Kansas,20,"Kingman County",20095,48,15,63,0.7619047619
Yes,Kansas,20,"Kiowa County",20097,.,.,.,0.8275862069
Yes,Kansas,20,"Labette County",20099,240,55,295,0.813559322
Yes,Kansas,20,"Lane County",20101,.,.,.,0.75
Yes,Kansas,20,"Leavenworth County",20103,297,92,389,0.763496144
Yes,Kansas,20,"Lincoln County",20105,.,.,.,0.9047619048
Yes,Kansas,20,"Linn County",20107,69,20,89,0.7752808989
Yes,Kansas,20,"Logan County",20109,.,.,.,0.8181818182
Yes,Kansas,20,"Lyon County",20111,226,57,283,0.7985865724
Yes,Kansas,20,"McPherson County",20113,182,32,214,0.8504672897
Yes,Kansas,20,"Marion County",20115,96,14,110,0.8727272727
Yes,Kansas,20,"Marshall County",20117,81,19,100,0.81
Yes,Kansas,20,"Meade County",20119,.,.,.,0.7916666667
Yes,Kansas,20,"Miami County",20121,175,47,222,0.7882882883
Yes,Kansas,20,"Mitchell County",20123,56,11,67,0.8358208955
Yes,Kansas,20,"Montgomery County",20125,368,111,479,0.7682672234
Yes,Kansas,20,"Morris County",20127,41,13,54,0.7592592593
Yes,Kansas,20,"Morton County",20129,.,.,.,0.7931034483
Yes,Kansas,20,"Nemaha County",20131,65,19,84,0.7738095238
Yes,Kansas,20,"Neosho County",20133,177,47,224,0.7901785714
Yes,Kansas,20,"Ness County",20135,.,.,.,0.7692307692
Yes,Kansas,20,"Norton County",20137,.,.,.,0.7954545455
Yes,Kansas,20,"Osage County",20139,132,40,172,0.7674418605
Yes,Kansas,20,"Osborne County",20141,.,.,.,0.82
Yes,Kansas,20,"Ottawa County",20143,.,.,.,0.8367346939
Yes,Kansas,20,"Pawnee County",20145,52,20,72,0.7222222222
Yes,Kansas,20,"Phillips County",20147,.,.,.,0.8474576271
Yes,Kansas,20,"Pottawatomie County",20149,98,29,127,0.7716535433
Yes,Kansas,20,"Pratt County",20151,73,19,92,0.7934782609
Yes,Kansas,20,"Rawlins County",20153,.,.,.,0.9032258065
Yes,Kansas,20,"Reno County",20155,487,127,614,0.7931596091
Yes,Kansas,20,"Republic County",20157,.,.,.,0.862745098
Yes,Kansas,20,"Rice County",20159,70,17,87,0.8045977011
Yes,Kansas,20,"Riley County",20161,207,45,252,0.8214285714
Yes,Kansas,20,"Rooks County",20163,.,.,.,0.8823529412
Yes,Kansas,20,"Rush County",20165,.,.,.,0.829787234
Yes,Kansas,20,"Russell County",20167,82,13,95,0.8631578947
Yes,Kansas,20,"Saline County",20169,406,144,550,0.7381818182
Yes,Kansas,20,"Scott County",20171,.,.,.,0.8076923077
Yes,Kansas,20,"Sedgwick County",20173,2340,773,3113,0.7516864761
Yes,Kansas,20,"Seward County",20175,96,31,127,0.7559055118
Yes,Kansas,20,"Shawnee County",20177,1144,355,1499,0.7631754503
Yes,Kansas,20,"Sheridan County",20179,.,.,.,0.7741935484
Yes,Kansas,20,"Sherman County",20181,61,19,80,0.7625
Yes,Kansas,20,"Smith County",20183,30,11,41,0.7317073171
Yes,Kansas,20,"Stafford County",20185,23,12,35,0.6571428571
Yes,Kansas,20,"Stanton County",20187,.,.,.,0.8
Yes,Kansas,20,"Stevens County",20189,.,.,.,0.8275862069
Yes,Kansas,20,"Sumner County",20191,125,48,173,0.7225433526
Yes,Kansas,20,"Thomas County",20193,43,11,54,0.7962962963
Yes,Kansas,20,"Trego County",20195,.,.,.,0.8
Yes,Kansas,20,"Wabaunsee County",20197,41,11,52,0.7884615385
Yes,Kansas,20,"Wallace County",20199,.,.,.,0.8181818182
Yes,Kansas,20,"Washington County",20201,.,.,.,0.8222222222
Yes,Kansas,20,"Wichita County",20203,.,.,.,0.8333333333
Yes,Kansas,20,"Wilson County",20205,117,40,157,0.7452229299
Yes,Kansas,20,"Woodson County",20207,33,13,46,0.7173913043
Yes,Kansas,20,"Wyandotte County",20209,923,359,1282,0.7199687988
Yes,Kansas,20,,20999,.,.,.,0.8
Yes,Kentucky,21,"Adair County",21001,373,91,464,0.8038793103
Yes,Kentucky,21,"Allen County",21003,290,119,409,0.7090464548
Yes,Kentucky,21,"Anderson County",21005,144,49,193,0.7461139896
Yes,Kentucky,21,"Ballard County",21007,106,36,142,0.7464788732
Yes,Kentucky,21,"Barren County",21009,690,203,893,0.7726763718
Yes,Kentucky,21,"Bath County",21011,253,82,335,0.7552238806
Yes,Kentucky,21,"Bell County",21013,823,260,1083,0.7599261311
Yes,Kentucky,21,"Boone County",21015,385,115,500,0.77
Yes,Kentucky,21,"Bourbon County",21017,223,81,304,0.7335526316
Yes,Kentucky,21,"Boyd County",21019,585,254,839,0.6972586412
Yes,Kentucky,21,"Boyle County",21021,354,113,467,0.7580299786
Yes,Kentucky,21,"Bracken County",21023,105,30,135,0.7777777778
Yes,Kentucky,21,"Breathitt County",21025,425,105,530,0.8018867925
Yes,Kentucky,21,"Breckinridge County",21027,324,77,401,0.8079800499
Yes,Kentucky,21,"Bullitt County",21029,498,161,659,0.7556904401
Yes,Kentucky,21,"Butler County",21031,183,66,249,0.734939759
Yes,Kentucky,21,"Caldwell County",21033,159,52,211,0.7535545024
Yes,Kentucky,21,"Calloway County",21035,333,100,433,0.7690531178
Yes,Kentucky,21,"Campbell County",21037,398,119,517,0.7698259188
Yes,Kentucky,21,"Carlisle County",21039,65,18,83,0.7831325301
Yes,Kentucky,21,"Carroll County",21041,139,67,206,0.6747572816
Yes,Kentucky,21,"Carter County",21043,543,219,762,0.7125984252
Yes,Kentucky,21,"Casey County",21045,390,95,485,0.8041237113
Yes,Kentucky,21,"Christian County",21047,547,268,815,0.6711656442
Yes,Kentucky,21,"Clark County",21049,333,102,435,0.7655172414
Yes,Kentucky,21,"Clay County",21051,818,210,1028,0.7957198444
Yes,Kentucky,21,"Clinton County",21053,284,112,396,0.7171717172
Yes,Kentucky,21,"Crittenden County",21055,108,23,131,0.8244274809
Yes,Kentucky,21,"Cumberland County",21057,168,68,236,0.7118644068
Yes,Kentucky,21,"Daviess County",21059,1015,332,1347,0.7535263549
Yes,Kentucky,21,"Edmonson County",21061,224,52,276,0.8115942029
Yes,Kentucky,21,"Elliott County",21063,130,39,169,0.7692307692
Yes,Kentucky,21,"Estill County",21065,312,103,415,0.7518072289
Yes,Kentucky,21,"Fayette County",21067,1410,538,1948,0.7238193018
Yes,Kentucky,21,"Fleming County",21069,256,71,327,0.7828746177
Yes,Kentucky,21,"Floyd County",21071,1171,353,1524,0.7683727034
Yes,Kentucky,21,"Franklin County",21073,847,247,1094,0.7742230347
Yes,Kentucky,21,"Fulton County",21075,134,50,184,0.7282608696
Yes,Kentucky,21,"Gallatin County",21077,88,26,114,0.7719298246
Yes,Kentucky,21,"Garrard County",21079,220,83,303,0.7260726073
Yes,Kentucky,21,"Grant County",21081,194,81,275,0.7054545455
Yes,Kentucky,21,"Graves County",21083,441,165,606,0.7277227723
Yes,Kentucky,21,"Grayson County",21085,464,119,583,0.7958833619
Yes,Kentucky,21,"Green County",21087,277,52,329,0.8419452888
Yes,Kentucky,21,"Greenup County",21089,516,172,688,0.75
Yes,Kentucky,21,"Hancock County",21091,95,23,118,0.8050847458
Yes,Kentucky,21,"Hardin County",21093,838,308,1146,0.7312390925
Yes,Kentucky,21,"Harlan County",21095,822,258,1080,0.7611111111
Yes,Kentucky,21,"Harrison County",21097,262,71,333,0.7867867868
Yes,Kentucky,21,"Hart County",21099,370,122,492,0.7520325203
Yes,Kentucky,21,"Henderson County",21101,407,125,532,0.765037594
Yes,Kentucky,21,"Henry County",21103,139,56,195,0.7128205128
Yes,Kentucky,21,"Hickman County",21105,88,23,111,0.7927927928
Yes,Kentucky,21,"Hopkins County",21107,568,157,725,0.7834482759
Yes,Kentucky,21,"Jackson County",21109,380,127,507,0.7495069034
Yes,Kentucky,21,"Jefferson County",21111,4567,1915,6482,0.7045664918
Yes,Kentucky,21,"Jessamine County",21113,366,98,464,0.7887931034
Yes,Kentucky,21,"Johnson County",21115,603,226,829,0.7273823884
Yes,Kentucky,21,"Kenton County",21117,794,287,1081,0.7345050879
Yes,Kentucky,21,"Knott County",21119,504,161,665,0.7578947368
Yes,Kentucky,21,"Knox County",21121,1035,372,1407,0.7356076759
Yes,Kentucky,21,"Larue County",21123,218,54,272,0.8014705882
Yes,Kentucky,21,"Laurel County",21125,1397,512,1909,0.7317967522
Yes,Kentucky,21,"Lawrence County",21127,327,110,437,0.7482837529
Yes,Kentucky,21,"Lee County",21129,208,73,281,0.7402135231
Yes,Kentucky,21,"Leslie County",21131,444,114,558,0.7956989247
Yes,Kentucky,21,"Letcher County",21133,595,202,797,0.7465495609
Yes,Kentucky,21,"Lewis County",21135,323,102,425,0.76
Yes,Kentucky,21,"Lincoln County",21137,443,132,575,0.7704347826
Yes,Kentucky,21,"Livingston County",21139,133,36,169,0.7869822485
Yes,Kentucky,21,"Logan County",21141,353,140,493,0.7160243408
Yes,Kentucky,21,"Lyon County",21143,87,28,115,0.7565217391
Yes,Kentucky,21,"McCracken County",21145,678,250,928,0.7306034483
Yes,Kentucky,21,"McCreary County",21147,465,135,600,0.775
Yes,Kentucky,21,"McLean County",21149,127,30,157,0.8089171975
Yes,Kentucky,21,"Madison County",21151,931,303,1234,0.7544570502
Yes,Kentucky,21,"Magoffin County",21153,421,99,520,0.8096153846
Yes,Kentucky,21,"Marion County",21155,279,67,346,0.8063583815
Yes,Kentucky,21,"Marshall County",21157,315,96,411,0.7664233577
Yes,Kentucky,21,"Martin County",21159,261,68,329,0.7933130699
Yes,Kentucky,21,"Mason County",21161,290,56,346,0.838150289
Yes,Kentucky,21,"Meade County",21163,234,99,333,0.7027027027
Yes,Kentucky,21,"Menifee County",21165,163,39,202,0.8069306931
Yes,Kentucky,21,"Mercer County",21167,227,69,296,0.7668918919
Yes,Kentucky,21,"Metcalfe County",21169,242,64,306,0.7908496732
Yes,Kentucky,21,"Monroe County",21171,242,61,303,0.798679868
Yes,Kentucky,21,"Montgomery County",21173,403,120,523,0.7705544933
Yes,Kentucky,21,"Morgan County",21175,283,88,371,0.7628032345
Yes,Kentucky,21,"Muhlenberg County",21177,523,180,703,0.7439544808
Yes,Kentucky,21,"Nelson County",21179,504,157,661,0.7624810893
Yes,Kentucky,21,"Nicholas County",21181,151,41,192,0.7864583333
Yes,Kentucky,21,"Ohio County",21183,285,121,406,0.7019704433
Yes,Kentucky,21,"Oldham County",21185,166,64,230,0.7217391304
Yes,Kentucky,21,"Owen County",21187,124,41,165,0.7515151515
Yes,Kentucky,21,"Owsley County",21189,130,47,177,0.7344632768
Yes,Kentucky,21,"Pendleton County",21191,149,39,188,0.7925531915
Yes,Kentucky,21,"Perry County",21193,802,270,1072,0.7481343284
Yes,Kentucky,21,"Pike County",21195,1284,519,1803,0.7121464226
Yes,Kentucky,21,"Powell County",21197,269,78,347,0.7752161383
Yes,Kentucky,21,"Pulaski County",21199,1140,382,1522,0.7490144547
Yes,Kentucky,21,"Robertson County",21201,47,11,58,0.8103448276
Yes,Kentucky,21,"Rockcastle County",21203,454,149,603,0.7529021559
Yes,Kentucky,21,"Rowan County",21205,378,147,525,0.72
Yes,Kentucky,21,"Russell County",21207,370,127,497,0.7444668008
Yes,Kentucky,21,"Scott County",21209,302,101,403,0.7493796526
Yes,Kentucky,21,"Shelby County",21211,273,87,360,0.7583333333
Yes,Kentucky,21,"Simpson County",21213,161,67,228,0.7061403509
Yes,Kentucky,21,"Spencer County",21215,104,40,144,0.7222222222
Yes,Kentucky,21,"Taylor County",21217,424,123,547,0.7751371115
Yes,Kentucky,21,"Todd County",21219,152,45,197,0.7715736041
Yes,Kentucky,21,"Trigg County",21221,148,54,202,0.7326732673
Yes,Kentucky,21,"Trimble County",21223,97,39,136,0.7132352941
Yes,Kentucky,21,"Union County",21225,134,48,182,0.7362637363
Yes,Kentucky,21,"Warren County",21227,896,377,1273,0.7038491752
Yes,Kentucky,21,"Washington County",21229,180,49,229,0.7860262009
Yes,Kentucky,21,"Wayne County",21231,514,174,688,0.7470930233
Yes,Kentucky,21,"Webster County",21233,122,44,166,0.734939759
Yes,Kentucky,21,"Whitley County",21235,975,384,1359,0.7174392936
Yes,Kentucky,21,"Wolfe County",21237,240,71,311,0.7717041801
Yes,Kentucky,21,"Woodford County",21239,143,53,196,0.7295918367
Yes,Kentucky,21,,21999,58,22,80,0.725
Yes,Louisiana,22,"Acadia Parish",22001,936,287,1223,0.7653311529
Yes,Louisiana,22,"Allen Parish",22003,289,143,432,0.6689814815
Yes,Louisiana,22,"Ascension Parish",22005,441,175,616,0.7159090909
Yes,Louisiana,22,"Assumption Parish",22007,298,123,421,0.7078384798
Yes,Louisiana,22,"Avoyelles Parish",22009,811,298,1109,0.73128945
Yes,Louisiana,22,"Beauregard Parish",22011,342,169,511,0.6692759295
Yes,Louisiana,22,"Bienville Parish",22013,209,108,317,0.6593059937
Yes,Louisiana,22,"Bossier Parish",22015,653,336,989,0.6602628918
Yes,Louisiana,22,"Caddo Parish",22017,2171,1254,3425,0.6338686131
Yes,Louisiana,22,"Calcasieu Parish",22019,1323,767,2090,0.6330143541
Yes,Louisiana,22,"Caldwell Parish",22021,159,71,230,0.6913043478
Yes,Louisiana,22,"Cameron Parish",22023,42,17,59,0.7118644068
Yes,Louisiana,22,"Catahoula Parish",22025,180,65,245,0.7346938776
Yes,Louisiana,22,"Claiborne Parish",22027,207,125,332,0.6234939759
Yes,Louisiana,22,"Concordia Parish",22029,285,170,455,0.6263736264
Yes,Louisiana,22,"De Soto Parish",22031,311,190,501,0.620758483
Yes,Louisiana,22,"East Baton Rouge Parish",22033,2473,1230,3703,0.667836889
Yes,Louisiana,22,"East Carroll Parish",22035,156,65,221,0.7058823529
Yes,Louisiana,22,"East Feliciana Parish",22037,244,97,341,0.715542522
Yes,Louisiana,22,"Evangeline Parish",22039,604,258,862,0.7006960557
Yes,Louisiana,22,"Franklin Parish",22041,358,151,509,0.7033398821
Yes,Louisiana,22,"Grant Parish",22043,221,97,318,0.6949685535
Yes,Louisiana,22,"Iberia Parish",22045,804,378,1182,0.6802030457
Yes,Louisiana,22,"Iberville Parish",22047,254,138,392,0.6479591837
Yes,Louisiana,22,"Jackson Parish",22049,175,85,260,0.6730769231
Yes,Louisiana,22,"Jefferson Parish",22051,2294,919,3213,0.7139744787
Yes,Louisiana,22,"Jefferson Davis Parish",22053,427,182,609,0.7011494253
Yes,Louisiana,22,"Lafayette Parish",22055,1818,654,2472,0.7354368932
Yes,Louisiana,22,"Lafourche Parish",22057,1090,349,1439,0.7574704656
Yes,Louisiana,22,"La Salle Parish",22059,208,69,277,0.7509025271
Yes,Louisiana,22,"Lincoln Parish",22061,367,130,497,0.7384305835
Yes,Louisiana,22,"Livingston Parish",22063,665,243,908,0.7323788546
Yes,Louisiana,22,"Madison Parish",22065,142,82,224,0.6339285714
Yes,Louisiana,22,"Morehouse Parish",22067,383,142,525,0.7295238095
Yes,Louisiana,22,"Natchitoches Parish",22069,505,222,727,0.6946354883
Yes,Louisiana,22,"Orleans Parish",22071,2638,1357,3995,0.6603254068
Yes,Louisiana,22,"Ouachita Parish",22073,1539,704,2243,0.6861346411
Yes,Louisiana,22,"Plaquemines Parish",22075,124,46,170,0.7294117647
Yes,Louisiana,22,"Pointe Coupee Parish",22077,215,121,336,0.6398809524
Yes,Louisiana,22,"Rapides Parish",22079,1708,692,2400,0.7116666667
Yes,Louisiana,22,"Red River Parish",22081,129,87,216,0.5972222222
Yes,Louisiana,22,"Richland Parish",22083,368,179,547,0.6727605119
Yes,Louisiana,22,"Sabine Parish",22085,339,120,459,0.7385620915
Yes,Louisiana,22,"St. Bernard Parish",22087,281,105,386,0.7279792746
Yes,Louisiana,22,"St. Charles Parish",22089,223,113,336,0.6636904762
Yes,Louisiana,22,"St. Helena Parish",22091,201,107,308,0.6525974026
Yes,Louisiana,22,"St. James Parish",22093,170,92,262,0.6488549618
Yes,Louisiana,22,"St. John the Baptist Parish",22095,296,193,489,0.6053169734
Yes,Louisiana,22,"St. Landry Parish",22097,1484,620,2104,0.7053231939
Yes,Louisiana,22,"St. Martin Parish",22099,651,243,894,0.7281879195
Yes,Louisiana,22,"St. Mary Parish",22101,615,316,931,0.6605800215
Yes,Louisiana,22,"St. Tammany Parish",22103,1142,481,1623,0.7036352434
Yes,Louisiana,22,"Tangipahoa Parish",22105,1348,585,1933,0.6973616141
Yes,Louisiana,22,"Tensas Parish",22107,107,60,167,0.6407185629
Yes,Louisiana,22,"Terrebonne Parish",22109,1445,470,1915,0.7545691906
Yes,Louisiana,22,"Union Parish",22111,278,125,403,0.6898263027
Yes,Louisiana,22,"Vermilion Parish",22113,672,224,896,0.75
Yes,Louisiana,22,"Vernon Parish",22115,397,208,605,0.6561983471
Yes,Louisiana,22,"Washington Parish",22117,947,336,1283,0.7381137958
Yes,Louisiana,22,"Webster Parish",22119,552,229,781,0.7067861716
Yes,Louisiana,22,"West Baton Rouge Parish",22121,183,68,251,0.7290836653
Yes,Louisiana,22,"West Carroll Parish",22123,230,62,292,0.7876712329
Yes,Louisiana,22,"West Feliciana Parish",22125,92,56,148,0.6216216216
Yes,Louisiana,22,"Winn Parish",22127,213,109,322,0.6614906832
Yes,Louisiana,22,,22999,23,16,39,0.5897435897
Yes,Maine,23,"Androscoggin County",23001,1461,295,1756,0.8320045558
Yes,Maine,23,"Aroostook County",23003,2476,386,2862,0.8651292802
Yes,Maine,23,"Cumberland County",23005,2270,475,2745,0.8269581056
Yes,Maine,23,"Franklin County",23007,485,93,578,0.839100346
Yes,Maine,23,"Hancock County",23009,714,151,865,0.825433526
Yes,Maine,23,"Kennebec County",23011,1693,354,2047,0.8270639961
Yes,Maine,23,"Knox County",23013,511,128,639,0.799687011
Yes,Maine,23,"Lincoln County",23015,403,66,469,0.8592750533
Yes,Maine,23,"Oxford County",23017,1064,187,1251,0.8505195843
Yes,Maine,23,"Penobscot County",23019,2673,607,3280,0.8149390244
Yes,Maine,23,"Piscataquis County",23021,421,85,506,0.8320158103
Yes,Maine,23,"Sagadahoc County",23023,329,73,402,0.8184079602
Yes,Maine,23,"Somerset County",23025,1204,231,1435,0.8390243902
Yes,Maine,23,"Waldo County",23027,667,124,791,0.8432364096
Yes,Maine,23,"Washington County",23029,851,156,1007,0.8450844091
Yes,Maine,23,"York County",23031,2153,429,2582,0.8338497289
Yes,Maine,23,,23999,.,.,.,0.7368421053
Yes,Maryland,24,"Allegany County",24001,903,302,1205,0.7493775934
Yes,Maryland,24,"Anne Arundel County",24003,2127,612,2739,0.7765607886
Yes,Maryland,24,"Baltimore County",24005,5113,1603,6716,0.7613162597
Yes,Maryland,24,"Calvert County",24009,379,120,499,0.7595190381
Yes,Maryland,24,"Caroline County",24011,341,99,440,0.775
Yes,Maryland,24,"Carroll County",24013,727,169,896,0.8113839286
Yes,Maryland,24,"Cecil County",24015,652,227,879,0.7417519909
Yes,Maryland,24,"Charles County",24017,707,232,939,0.7529286475
Yes,Maryland,24,"Dorchester County",24019,513,148,661,0.776096823
Yes,Maryland,24,"Frederick County",24021,1072,314,1386,0.7734487734
Yes,Maryland,24,"Garrett County",24023,426,70,496,0.8588709677
Yes,Maryland,24,"Harford County",24025,1126,391,1517,0.7422544496
Yes,Maryland,24,"Howard County",24027,1308,310,1618,0.8084054388
Yes,Maryland,24,"Kent County",24029,196,64,260,0.7538461538
Yes,Maryland,24,"Montgomery County",24031,4924,1488,6412,0.7679351216
Yes,Maryland,24,"Prince George",24033,3808,1545,5353,0.7113767981
Yes,Maryland,24,"Queen Anne",24035,226,60,286,0.7902097902
Yes,Maryland,24,"St. Mary",24037,570,188,758,0.7519788918
Yes,Maryland,24,"Somerset County",24039,359,120,479,0.7494780793
Yes,Maryland,24,"Talbot County",24041,330,77,407,0.8108108108
Yes,Maryland,24,"Washington County",24043,1266,366,1632,0.7757352941
Yes,Maryland,24,"Wicomico County",24045,1049,339,1388,0.7557636888
Yes,Maryland,24,"Worcester County",24047,441,154,595,0.7411764706
Yes,Maryland,24,"Baltimore city",24510,6283,2824,9107,0.6899088613
Yes,Maryland,24,,24999,26,12,38,0.6842105263
Yes,Massachusetts,25,"Barnstable County",25001,1789,492,2281,0.7843051293
Yes,Massachusetts,25,"Berkshire County",25003,1562,446,2008,0.7778884462
Yes,Massachusetts,25,"Bristol County",25005,7549,1904,9453,0.7985824606
Yes,Massachusetts,25,"Dukes County",25007,125,37,162,0.7716049383
Yes,Massachusetts,25,"Essex County",25009,7562,1848,9410,0.8036131775
Yes,Massachusetts,25,"Franklin County",25011,750,178,928,0.8081896552
Yes,Massachusetts,25,"Hampden County",25013,5951,1494,7445,0.7993284083
Yes,Massachusetts,25,"Hampshire County",25015,1018,236,1254,0.8118022329
Yes,Massachusetts,25,"Middlesex County",25017,10117,2553,12670,0.7985003946
Yes,Massachusetts,25,"Nantucket County",25019,35,18,53,0.6603773585
Yes,Massachusetts,25,"Norfolk County",25021,4532,1144,5676,0.7984496124
Yes,Massachusetts,25,"Plymouth County",25023,4309,1173,5482,0.7860269974
Yes,Massachusetts,25,"Suffolk County",25025,8888,2321,11209,0.7929342493
Yes,Massachusetts,25,"Worcester County",25027,7086,1690,8776,0.8074293528
Yes,Massachusetts,25,,25999,21,11,32,0.65625
Yes,Michigan,26,"Alcona County",26001,135,41,176,0.7670454545
Yes,Michigan,26,"Alger County",26003,77,21,98,0.7857142857
Yes,Michigan,26,"Allegan County",26005,527,130,657,0.802130898
Yes,Michigan,26,"Alpena County",26007,386,109,495,0.7797979798
Yes,Michigan,26,"Antrim County",26009,201,49,250,0.804
Yes,Michigan,26,"Arenac County",26011,195,51,246,0.7926829268
Yes,Michigan,26,"Baraga County",26013,.,.,.,0.8611111111
Yes,Michigan,26,"Barry County",26015,311,79,390,0.7974358974
Yes,Michigan,26,"Bay County",26017,945,289,1234,0.765802269
Yes,Michigan,26,"Benzie County",26019,139,30,169,0.8224852071
Yes,Michigan,26,"Berrien County",26021,1154,416,1570,0.7350318471
Yes,Michigan,26,"Branch County",26023,341,81,422,0.808056872
Yes,Michigan,26,"Calhoun County",26025,1202,380,1582,0.7597977244
Yes,Michigan,26,"Cass County",26027,473,116,589,0.8030560272
Yes,Michigan,26,"Charlevoix County",26029,170,50,220,0.7727272727
Yes,Michigan,26,"Cheboygan County",26031,260,82,342,0.7602339181
Yes,Michigan,26,"Chippewa County",26033,309,72,381,0.811023622
Yes,Michigan,26,"Clare County",26035,463,111,574,0.8066202091
Yes,Michigan,26,"Clinton County",26037,245,70,315,0.7777777778
Yes,Michigan,26,"Crawford County",26039,169,37,206,0.8203883495
Yes,Michigan,26,"Delta County",26041,409,81,490,0.8346938776
Yes,Michigan,26,"Dickinson County",26043,195,54,249,0.7831325301
Yes,Michigan,26,"Eaton County",26045,526,152,678,0.7758112094
Yes,Michigan,26,"Emmet County",26047,221,57,278,0.7949640288
Yes,Michigan,26,"Genesee County",26049,3079,1276,4355,0.7070034443
Yes,Michigan,26,"Gladwin County",26051,337,90,427,0.7892271663
Yes,Michigan,26,"Gogebic County",26053,203,39,242,0.8388429752
Yes,Michigan,26,"Grand Traverse County",26055,503,106,609,0.8259441708
Yes,Michigan,26,"Gratiot County",26057,396,93,489,0.8098159509
Yes,Michigan,26,"Hillsdale County",26059,419,110,529,0.7920604915
Yes,Michigan,26,"Houghton County",26061,297,80,377,0.7877984085
Yes,Michigan,26,"Huron County",26063,357,78,435,0.8206896552
Yes,Michigan,26,"Ingham County",26065,1719,567,2286,0.7519685039
Yes,Michigan,26,"Ionia County",26067,352,105,457,0.7702407002
Yes,Michigan,26,"Iosco County",26069,339,80,419,0.8090692124
Yes,Michigan,26,"Iron County",26071,178,51,229,0.7772925764
Yes,Michigan,26,"Isabella County",26073,430,100,530,0.8113207547
Yes,Michigan,26,"Jackson County",26075,1356,472,1828,0.7417943107
Yes,Michigan,26,"Kalamazoo County",26077,1390,424,1814,0.7662624035
Yes,Michigan,26,"Kalkaska County",26079,219,37,256,0.85546875
Yes,Michigan,26,"Kent County",26081,2996,871,3867,0.7747607965
Yes,Michigan,26,"Keweenaw County",26083,.,.,.,0.8260869565
Yes,Michigan,26,"Lake County",26085,193,51,244,0.7909836066
Yes,Michigan,26,"Lapeer County",26087,510,137,647,0.7882534776
Yes,Michigan,26,"Leelanau County",26089,72,20,92,0.7826086957
Yes,Michigan,26,"Lenawee County",26091,652,183,835,0.7808383234
Yes,Michigan,26,"Livingston County",26093,438,121,559,0.7835420394
Yes,Michigan,26,"Luce County",26095,73,14,87,0.8390804598
Yes,Michigan,26,"Mackinac County",26097,109,26,135,0.8074074074
Yes,Michigan,26,"Macomb County",26099,6953,1766,8719,0.7974538364
Yes,Michigan,26,"Manistee County",26101,233,43,276,0.8442028986
Yes,Michigan,26,"Marquette County",26103,402,85,487,0.8254620123
Yes,Michigan,26,"Mason County",26105,302,73,375,0.8053333333
Yes,Michigan,26,"Mecosta County",26107,324,74,398,0.8140703518
Yes,Michigan,26,"Menominee County",26109,205,42,247,0.8299595142
Yes,Michigan,26,"Midland County",26111,637,130,767,0.8305084746
Yes,Michigan,26,"Missaukee County",26113,161,35,196,0.8214285714
Yes,Michigan,26,"Monroe County",26115,926,289,1215,0.7621399177
Yes,Michigan,26,"Montcalm County",26117,569,166,735,0.7741496599
Yes,Michigan,26,"Montmorency County",26119,129,42,171,0.7543859649
Yes,Michigan,26,"Muskegon County",26121,1512,440,1952,0.7745901639
Yes,Michigan,26,"Newaygo County",26123,436,123,559,0.7799642218
Yes,Michigan,26,"Oakland County",26125,7013,2082,9095,0.7710830126
Yes,Michigan,26,"Oceana County",26127,224,77,301,0.7441860465
Yes,Michigan,26,"Ogemaw County",26129,337,86,423,0.7966903073
Yes,Michigan,26,"Ontonagon County",26131,66,26,92,0.7173913043
Yes,Michigan,26,"Osceola County",26133,259,56,315,0.8222222222
Yes,Michigan,26,"Oscoda County",26135,139,37,176,0.7897727273
Yes,Michigan,26,"Otsego County",26137,228,48,276,0.8260869565
Yes,Michigan,26,"Ottawa County",26139,764,213,977,0.7819856704
Yes,Michigan,26,"Presque Isle County",26141,155,38,193,0.8031088083
Yes,Michigan,26,"Roscommon County",26143,355,78,433,0.8198614319
Yes,Michigan,26,"Saginaw County",26145,1692,559,2251,0.7516659263
Yes,Michigan,26,"St. Clair County",26147,1336,391,1727,0.7735958309
Yes,Michigan,26,"St. Joseph County",26149,456,158,614,0.7426710098
Yes,Michigan,26,"Sanilac County",26151,427,120,547,0.7806215722
Yes,Michigan,26,"Schoolcraft County",26153,113,16,129,0.8759689922
Yes,Michigan,26,"Shiawassee County",26155,548,158,706,0.776203966
Yes,Michigan,26,"Tuscola County",26157,535,137,672,0.7961309524
Yes,Michigan,26,"Van Buren County",26159,639,189,828,0.7717391304
Yes,Michigan,26,"Washtenaw County",26161,1380,441,1821,0.7578253707
Yes,Michigan,26,"Wayne County",26163,16450,6283,22733,0.7236176484
Yes,Michigan,26,"Wexford County",26165,393,93,486,0.8086419753
Yes,Michigan,26,,26999,46,19,65,0.7076923077
Yes,Minnesota,27,"Aitkin County",27001,143,24,167,0.8562874251
Yes,Minnesota,27,"Anoka County",27003,1192,308,1500,0.7946666667
Yes,Minnesota,27,"Becker County",27005,219,57,276,0.7934782609
Yes,Minnesota,27,"Beltrami County",27007,336,97,433,0.7759815242
Yes,Minnesota,27,"Benton County",27009,248,64,312,0.7948717949
Yes,Minnesota,27,"Big Stone County",27011,.,.,.,0.8392857143
Yes,Minnesota,27,"Blue Earth County",27013,361,63,424,0.8514150943
Yes,Minnesota,27,"Brown County",27015,160,21,181,0.8839779006
Yes,Minnesota,27,"Carlton County",27017,219,43,262,0.8358778626
Yes,Minnesota,27,"Carver County",27019,198,47,245,0.8081632653
Yes,Minnesota,27,"Cass County",27021,213,60,273,0.7802197802
Yes,Minnesota,27,"Chippewa County",27023,70,16,86,0.8139534884
Yes,Minnesota,27,"Chisago County",27025,207,38,245,0.8448979592
Yes,Minnesota,27,"Clay County",27027,284,72,356,0.797752809
Yes,Minnesota,27,"Clearwater County",27029,98,17,115,0.852173913
Yes,Minnesota,27,"Cook County",27031,.,.,.,0.8529411765
Yes,Minnesota,27,"Cottonwood County",27033,65,16,81,0.8024691358
Yes,Minnesota,27,"Crow Wing County",27035,403,80,483,0.83436853
Yes,Minnesota,27,"Dakota County",27037,1307,328,1635,0.7993883792
Yes,Minnesota,27,"Dodge County",27039,.,.,.,0.85
Yes,Minnesota,27,"Douglas County",27041,252,51,303,0.8316831683
Yes,Minnesota,27,"Faribault County",27043,120,16,136,0.8823529412
Yes,Minnesota,27,"Fillmore County",27045,118,25,143,0.8251748252
Yes,Minnesota,27,"Freeborn County",27047,189,50,239,0.7907949791
Yes,Minnesota,27,"Goodhue County",27049,168,41,209,0.8038277512
Yes,Minnesota,27,"Grant County",27051,.,.,.,0.8367346939
Yes,Minnesota,27,"Hennepin County",27053,4441,1365,5806,0.764898381
Yes,Minnesota,27,"Houston County",27055,112,14,126,0.8888888889
Yes,Minnesota,27,"Hubbard County",27057,166,30,196,0.8469387755
Yes,Minnesota,27,"Isanti County",27059,180,48,228,0.7894736842
Yes,Minnesota,27,"Itasca County",27061,327,76,403,0.8114143921
Yes,Minnesota,27,"Jackson County",27063,75,16,91,0.8241758242
Yes,Minnesota,27,"Kanabec County",27065,127,25,152,0.8355263158
Yes,Minnesota,27,"Kandiyohi County",27067,286,46,332,0.8614457831
Yes,Minnesota,27,"Kittson County",27069,.,.,.,0.8378378378
Yes,Minnesota,27,"Koochiching County",27071,120,29,149,0.8053691275
Yes,Minnesota,27,"Lac qui Parle County",27073,46,13,59,0.7796610169
Yes,Minnesota,27,"Lake County",27075,.,.,.,0.9076923077
Yes,Minnesota,27,"Lake of the Woods County",27077,.,.,.,0.8571428571
Yes,Minnesota,27,"Le Sueur County",27079,100,22,122,0.8196721311
Yes,Minnesota,27,"Lincoln County",27081,.,.,.,0.8793103448
Yes,Minnesota,27,"Lyon County",27083,150,40,190,0.7894736842
Yes,Minnesota,27,"McLeod County",27085,169,25,194,0.8711340206
Yes,Minnesota,27,"Mahnomen County",27087,64,20,84,0.7619047619
Yes,Minnesota,27,"Marshall County",27089,63,19,82,0.7682926829
Yes,Minnesota,27,"Martin County",27091,188,45,233,0.8068669528
Yes,Minnesota,27,"Meeker County",27093,117,25,142,0.823943662
Yes,Minnesota,27,"Mille Lacs County",27095,178,50,228,0.7807017544
Yes,Minnesota,27,"Morrison County",27097,229,47,276,0.8297101449
Yes,Minnesota,27,"Mower County",27099,274,52,326,0.8404907975
Yes,Minnesota,27,"Murray County",27101,.,.,.,0.9038461538
Yes,Minnesota,27,"Nicollet County",27103,150,42,192,0.78125
Yes,Minnesota,27,"Nobles County",27105,120,28,148,0.8108108108
Yes,Minnesota,27,"Norman County",27107,.,.,.,0.8333333333
Yes,Minnesota,27,"Olmsted County",27109,560,145,705,0.7943262411
Yes,Minnesota,27,"Otter Tail County",27111,387,74,461,0.8394793926
Yes,Minnesota,27,"Pennington County",27113,102,22,124,0.8225806452
Yes,Minnesota,27,"Pine County",27115,235,54,289,0.8131487889
Yes,Minnesota,27,"Pipestone County",27117,61,13,74,0.8243243243
Yes,Minnesota,27,"Polk County",27119,255,56,311,0.8199356913
Yes,Minnesota,27,"Pope County",27121,56,11,67,0.8358208955
Yes,Minnesota,27,"Ramsey County",27123,2453,787,3240,0.7570987654
Yes,Minnesota,27,"Red Lake County",27125,.,.,.,0.75
Yes,Minnesota,27,"Redwood County",27127,71,26,97,0.7319587629
Yes,Minnesota,27,"Renville County",27129,92,16,108,0.8518518519
Yes,Minnesota,27,"Rice County",27131,244,44,288,0.8472222222
Yes,Minnesota,27,"Rock County",27133,.,.,.,0.8769230769
Yes,Minnesota,27,"Roseau County",27135,79,18,97,0.8144329897
Yes,Minnesota,27,"St. Louis County",27137,1331,306,1637,0.813072694
Yes,Minnesota,27,"Scott County",27139,338,88,426,0.79342723
Yes,Minnesota,27,"Sherburne County",27141,317,57,374,0.8475935829
Yes,Minnesota,27,"Sibley County",27143,54,21,75,0.72
Yes,Minnesota,27,"Stearns County",27145,613,131,744,0.8239247312
Yes,Minnesota,27,"Steele County",27147,220,39,259,0.8494208494
Yes,Minnesota,27,"Stevens County",27149,.,.,.,0.8076923077
Yes,Minnesota,27,"Swift County",27151,64,12,76,0.8421052632
Yes,Minnesota,27,"Todd County",27153,167,32,199,0.8391959799
Yes,Minnesota,27,"Traverse County",27155,.,.,.,0.8
Yes,Minnesota,27,"Wabasha County",27157,132,20,152,0.8684210526
Yes,Minnesota,27,"Wadena County",27159,134,24,158,0.8481012658
Yes,Minnesota,27,"Waseca County",27161,118,24,142,0.8309859155
Yes,Minnesota,27,"Washington County",27163,691,190,881,0.7843359818
Yes,Minnesota,27,"Watonwan County",27165,65,17,82,0.7926829268
Yes,Minnesota,27,"Wilkin County",27167,54,12,66,0.8181818182
Yes,Minnesota,27,"Winona County",27169,338,71,409,0.826405868
Yes,Minnesota,27,"Wright County",27171,440,79,519,0.8477842004
Yes,Minnesota,27,"Yellow Medicine County",27173,.,.,.,0.8857142857
Yes,Minnesota,27,,27999,.,.,.,0.7741935484
Yes,Mississippi,28,"Adams County",28001,495,231,726,0.6818181818
Yes,Mississippi,28,"Alcorn County",28003,705,227,932,0.7564377682
Yes,Mississippi,28,"Amite County",28005,169,94,263,0.6425855513
Yes,Mississippi,28,"Attala County",28007,329,145,474,0.694092827
Yes,Mississippi,28,"Benton County",28009,155,69,224,0.6919642857
Yes,Mississippi,28,"Bolivar County",28011,627,347,974,0.6437371663
Yes,Mississippi,28,"Calhoun County",28013,296,114,410,0.7219512195
Yes,Mississippi,28,"Carroll County",28015,181,76,257,0.7042801556
Yes,Mississippi,28,"Chickasaw County",28017,347,154,501,0.6926147705
Yes,Mississippi,28,"Choctaw County",28019,184,52,236,0.7796610169
Yes,Mississippi,28,"Claiborne County",28021,103,74,177,0.581920904
Yes,Mississippi,28,"Clarke County",28023,255,102,357,0.7142857143
Yes,Mississippi,28,"Clay County",28025,335,135,470,0.7127659574
Yes,Mississippi,28,"Coahoma County",28027,564,267,831,0.678700361
Yes,Mississippi,28,"Copiah County",28029,337,151,488,0.6905737705
Yes,Mississippi,28,"Covington County",28031,281,124,405,0.6938271605
Yes,Mississippi,28,"DeSoto County",28033,899,319,1218,0.7380952381
Yes,Mississippi,28,"Forrest County",28035,811,283,1094,0.7413162706
Yes,Mississippi,28,"Franklin County",28037,134,57,191,0.7015706806
Yes,Mississippi,28,"George County",28039,238,88,326,0.7300613497
Yes,Mississippi,28,"Greene County",28041,168,69,237,0.7088607595
Yes,Mississippi,28,"Grenada County",28043,418,172,590,0.7084745763
Yes,Mississippi,28,"Hancock County",28045,448,149,597,0.7504187605
Yes,Mississippi,28,"Harrison County",28047,1587,759,2346,0.6764705882
Yes,Mississippi,28,"Hinds County",28049,1848,936,2784,0.6637931034
Yes,Mississippi,28,"Holmes County",28051,408,242,650,0.6276923077
Yes,Mississippi,28,"Humphreys County",28053,224,105,329,0.6808510638
Yes,Mississippi,28,"Issaquena County",28055,.,.,.,0.7619047619
Yes,Mississippi,28,"Itawamba County",28057,418,113,531,0.7871939736
Yes,Mississippi,28,"Jackson County",28059,998,451,1449,0.6887508627
Yes,Mississippi,28,"Jasper County",28061,322,133,455,0.7076923077
Yes,Mississippi,28,"Jefferson County",28063,166,95,261,0.6360153257
Yes,Mississippi,28,"Jefferson Davis County",28065,225,123,348,0.6465517241
Yes,Mississippi,28,"Jones County",28067,903,363,1266,0.7132701422
Yes,Mississippi,28,"Kemper County",28069,177,68,245,0.7224489796
Yes,Mississippi,28,"Lafayette County",28071,383,159,542,0.7066420664
Yes,Mississippi,28,"Lamar County",28073,395,135,530,0.7452830189
Yes,Mississippi,28,"Lauderdale County",28075,830,416,1246,0.6661316212
Yes,Mississippi,28,"Lawrence County",28077,197,93,290,0.6793103448
Yes,Mississippi,28,"Leake County",28079,290,103,393,0.737913486
Yes,Mississippi,28,"Lee County",28081,1100,393,1493,0.7367716008
Yes,Mississippi,28,"Leflore County",28083,761,340,1101,0.6911898274
Yes,Mississippi,28,"Lincoln County",28085,431,174,605,0.7123966942
Yes,Mississippi,28,"Lowndes County",28087,790,348,1138,0.6942003515
Yes,Mississippi,28,"Madison County",28089,610,243,853,0.715123095
Yes,Mississippi,28,"Marion County",28091,479,196,675,0.7096296296
Yes,Mississippi,28,"Marshall County",28093,497,213,710,0.7
Yes,Mississippi,28,"Monroe County",28095,669,224,893,0.7491601344
Yes,Mississippi,28,"Montgomery County",28097,235,117,352,0.6676136364
Yes,Mississippi,28,"Neshoba County",28099,321,151,472,0.6800847458
Yes,Mississippi,28,"Newton County",28101,322,130,452,0.7123893805
Yes,Mississippi,28,"Noxubee County",28103,252,136,388,0.6494845361
Yes,Mississippi,28,"Oktibbeha County",28105,384,185,569,0.6748681898
Yes,Mississippi,28,"Panola County",28107,580,296,876,0.6621004566
Yes,Mississippi,28,"Pearl River County",28109,601,256,857,0.7012835473
Yes,Mississippi,28,"Perry County",28111,228,83,311,0.7331189711
Yes,Mississippi,28,"Pike County",28113,579,260,839,0.6901072706
Yes,Mississippi,28,"Pontotoc County",28115,496,165,661,0.7503782148
Yes,Mississippi,28,"Prentiss County",28117,503,187,690,0.7289855072
Yes,Mississippi,28,"Quitman County",28119,223,96,319,0.6990595611
Yes,Mississippi,28,"Rankin County",28121,793,333,1126,0.7042628774
Yes,Mississippi,28,"Scott County",28123,413,169,582,0.7096219931
Yes,Mississippi,28,"Sharkey County",28125,107,34,141,0.7588652482
Yes,Mississippi,28,"Simpson County",28127,381,157,538,0.7081784387
Yes,Mississippi,28,"Smith County",28129,218,87,305,0.7147540984
Yes,Mississippi,28,"Stone County",28131,206,85,291,0.7079037801
Yes,Mississippi,28,"Sunflower County",28133,491,269,760,0.6460526316
Yes,Mississippi,28,"Tallahatchie County",28135,314,133,447,0.7024608501
Yes,Mississippi,28,"Tate County",28137,347,144,491,0.7067209776
Yes,Mississippi,28,"Tippah County",28139,453,156,609,0.7438423645
Yes,Mississippi,28,"Tishomingo County",28141,399,104,503,0.7932405567
Yes,Mississippi,28,"Tunica County",28143,191,66,257,0.7431906615
Yes,Mississippi,28,"Union County",28145,425,167,592,0.7179054054
Yes,Mississippi,28,"Walthall County",28147,305,112,417,0.7314148681
Yes,Mississippi,28,"Warren County",28149,429,245,674,0.6364985163
Yes,Mississippi,28,"Washington County",28151,887,397,1284,0.6908099688
Yes,Mississippi,28,"Wayne County",28153,338,120,458,0.7379912664
Yes,Mississippi,28,"Webster County",28155,228,79,307,0.7426710098
Yes,Mississippi,28,"Wilkinson County",28157,153,86,239,0.640167364
Yes,Mississippi,28,"Winston County",28159,290,124,414,0.7004830918
Yes,Mississippi,28,"Yalobusha County",28161,304,122,426,0.7136150235
Yes,Mississippi,28,"Yazoo County",28163,382,170,552,0.6920289855
Yes,Mississippi,28,,28999,23,18,41,0.5609756098
Yes,Missouri,29,"Adair County",29001,243,66,309,0.786407767
Yes,Missouri,29,"Andrew County",29003,101,31,132,0.7651515152
Yes,Missouri,29,"Atchison County",29005,.,.,.,0.9101123596
Yes,Missouri,29,"Audrain County",29007,209,59,268,0.7798507463
Yes,Missouri,29,"Barry County",29009,322,95,417,0.7721822542
Yes,Missouri,29,"Barton County",29011,135,23,158,0.8544303797
Yes,Missouri,29,"Bates County",29013,151,34,185,0.8162162162
Yes,Missouri,29,"Benton County",29015,257,76,333,0.7717717718
Yes,Missouri,29,"Bollinger County",29017,153,41,194,0.7886597938
Yes,Missouri,29,"Boone County",29019,832,260,1092,0.7619047619
Yes,Missouri,29,"Buchanan County",29021,825,245,1070,0.7710280374
Yes,Missouri,29,"Butler County",29023,759,233,992,0.7651209677
Yes,Missouri,29,"Caldwell County",29025,77,29,106,0.7264150943
Yes,Missouri,29,"Callaway County",29027,310,88,398,0.7788944724
Yes,Missouri,29,"Camden County",29029,306,73,379,0.8073878628
Yes,Missouri,29,"Cape Girardeau County",29031,614,190,804,0.763681592
Yes,Missouri,29,"Carroll County",29033,79,14,93,0.8494623656
Yes,Missouri,29,"Carter County",29035,122,36,158,0.7721518987
Yes,Missouri,29,"Cass County",29037,353,107,460,0.7673913043
Yes,Missouri,29,"Cedar County",29039,178,37,215,0.8279069767
Yes,Missouri,29,"Chariton County",29041,81,12,93,0.8709677419
Yes,Missouri,29,"Christian County",29043,365,94,459,0.7952069717
Yes,Missouri,29,"Clark County",29045,74,17,91,0.8131868132
Yes,Missouri,29,"Clay County",29047,809,251,1060,0.7632075472
Yes,Missouri,29,"Clinton County",29049,124,33,157,0.7898089172
Yes,Missouri,29,"Cole County",29051,344,120,464,0.7413793103
Yes,Missouri,29,"Cooper County",29053,122,44,166,0.734939759
Yes,Missouri,29,"Crawford County",29055,330,85,415,0.7951807229
Yes,Missouri,29,"Dade County",29057,69,14,83,0.8313253012
Yes,Missouri,29,"Dallas County",29059,143,52,195,0.7333333333
Yes,Missouri,29,"Daviess County",29061,95,23,118,0.8050847458
Yes,Missouri,29,"DeKalb County",29063,108,33,141,0.7659574468
Yes,Missouri,29,"Dent County",29065,277,70,347,0.7982708934
Yes,Missouri,29,"Douglas County",29067,120,28,148,0.8108108108
Yes,Missouri,29,"Dunklin County",29069,623,188,811,0.7681874229
Yes,Missouri,29,"Franklin County",29071,568,169,737,0.7706919946
Yes,Missouri,29,"Gasconade County",29073,142,40,182,0.7802197802
Yes,Missouri,29,"Gentry County",29075,78,18,96,0.8125
Yes,Missouri,29,"Greene County",29077,1585,496,2081,0.7616530514
Yes,Missouri,29,"Grundy County",29079,138,30,168,0.8214285714
Yes,Missouri,29,"Harrison County",29081,139,39,178,0.7808988764
Yes,Missouri,29,"Henry County",29083,230,57,287,0.8013937282
Yes,Missouri,29,"Hickory County",29085,117,29,146,0.801369863
Yes,Missouri,29,"Holt County",29087,55,20,75,0.7333333333
Yes,Missouri,29,"Howard County",29089,75,29,104,0.7211538462
Yes,Missouri,29,"Howell County",29091,616,166,782,0.7877237852
Yes,Missouri,29,"Iron County",29093,236,52,288,0.8194444444
Yes,Missouri,29,"Jackson County",29095,3696,1349,5045,0.7326065411
Yes,Missouri,29,"Jasper County",29097,1057,327,1384,0.7637283237
Yes,Missouri,29,"Jefferson County",29099,1018,357,1375,0.7403636364
Yes,Missouri,29,"Johnson County",29101,214,78,292,0.7328767123
Yes,Missouri,29,"Knox County",29103,54,14,68,0.7941176471
Yes,Missouri,29,"Laclede County",29105,338,101,439,0.7699316629
Yes,Missouri,29,"Lafayette County",29107,197,60,257,0.766536965
Yes,Missouri,29,"Lawrence County",29109,309,75,384,0.8046875
Yes,Missouri,29,"Lewis County",29111,108,34,142,0.7605633803
Yes,Missouri,29,"Lincoln County",29113,296,125,421,0.703087886
Yes,Missouri,29,"Linn County",29115,156,39,195,0.8
Yes,Missouri,29,"Livingston County",29117,178,41,219,0.8127853881
Yes,Missouri,29,"McDonald County",29119,180,73,253,0.7114624506
Yes,Missouri,29,"Macon County",29121,168,29,197,0.8527918782
Yes,Missouri,29,"Madison County",29123,202,48,250,0.808
Yes,Missouri,29,"Maries County",29125,88,12,100,0.88
Yes,Missouri,29,"Marion County",29127,408,100,508,0.8031496063
Yes,Missouri,29,"Mercer County",29129,45,14,59,0.7627118644
Yes,Missouri,29,"Miller County",29131,258,61,319,0.8087774295
Yes,Missouri,29,"Mississippi County",29133,265,80,345,0.768115942
Yes,Missouri,29,"Moniteau County",29135,101,27,128,0.7890625
Yes,Missouri,29,"Monroe County",29137,78,31,109,0.7155963303
Yes,Missouri,29,"Montgomery County",29139,129,41,170,0.7588235294
Yes,Missouri,29,"Morgan County",29141,231,82,313,0.7380191693
Yes,Missouri,29,"New Madrid County",29143,360,116,476,0.756302521
Yes,Missouri,29,"Newton County",29145,458,125,583,0.7855917667
Yes,Missouri,29,"Nodaway County",29147,160,47,207,0.7729468599
Yes,Missouri,29,"Oregon County",29149,223,56,279,0.7992831541
Yes,Missouri,29,"Osage County",29151,76,13,89,0.8539325843
Yes,Missouri,29,"Ozark County",29153,114,37,151,0.7549668874
Yes,Missouri,29,"Pemiscot County",29155,380,157,537,0.7076350093
Yes,Missouri,29,"Perry County",29157,169,42,211,0.8009478673
Yes,Missouri,29,"Pettis County",29159,402,135,537,0.748603352
Yes,Missouri,29,"Phelps County",29161,496,122,618,0.8025889968
Yes,Missouri,29,"Pike County",29163,179,62,241,0.7427385892
Yes,Missouri,29,"Platte County",29165,272,87,359,0.7576601671
Yes,Missouri,29,"Polk County",29167,260,66,326,0.7975460123
Yes,Missouri,29,"Pulaski County",29169,290,121,411,0.7055961071
Yes,Missouri,29,"Putnam County",29171,85,16,101,0.8415841584
Yes,Missouri,29,"Ralls County",29173,122,21,143,0.8531468531
Yes,Missouri,29,"Randolph County",29175,297,89,386,0.7694300518
Yes,Missouri,29,"Ray County",29177,169,35,204,0.8284313725
Yes,Missouri,29,"Reynolds County",29179,120,26,146,0.8219178082
Yes,Missouri,29,"Ripley County",29181,310,101,411,0.7542579075
Yes,Missouri,29,"St. Charles County",29183,948,317,1265,0.7494071146
Yes,Missouri,29,"St. Clair County",29185,105,29,134,0.7835820896
Yes,Missouri,29,"Ste. Genevieve County",29186,142,41,183,0.7759562842
Yes,Missouri,29,"St. Francois County",29187,929,256,1185,0.7839662447
Yes,Missouri,29,"St. Louis County",29189,4254,1706,5960,0.7137583893
Yes,Missouri,29,"Saline County",29195,218,51,269,0.8104089219
Yes,Missouri,29,"Schuyler County",29197,68,15,83,0.8192771084
Yes,Missouri,29,"Scotland County",29199,48,15,63,0.7619047619
Yes,Missouri,29,"Scott County",29201,688,198,886,0.776523702
Yes,Missouri,29,"Shannon County",29203,141,34,175,0.8057142857
Yes,Missouri,29,"Shelby County",29205,86,17,103,0.8349514563
Yes,Missouri,29,"Stoddard County",29207,517,160,677,0.7636632201
Yes,Missouri,29,"Stone County",29209,218,66,284,0.7676056338
Yes,Missouri,29,"Sullivan County",29211,92,25,117,0.7863247863
Yes,Missouri,29,"Taney County",29213,448,161,609,0.7356321839
Yes,Missouri,29,"Texas County",29215,308,94,402,0.7661691542
Yes,Missouri,29,"Vernon County",29217,231,83,314,0.7356687898
Yes,Missouri,29,"Warren County",29219,158,71,229,0.6899563319
Yes,Missouri,29,"Washington County",29221,418,138,556,0.7517985612
Yes,Missouri,29,"Wayne County",29223,260,80,340,0.7647058824
Yes,Missouri,29,"Webster County",29225,254,59,313,0.8115015974
Yes,Missouri,29,"Worth County",29227,.,.,.,0.7352941176
Yes,Missouri,29,"Wright County",29229,229,75,304,0.7532894737
Yes,Missouri,29,"St. Louis city",29510,2898,1197,4095,0.7076923077
Yes,Missouri,29,,29999,42,16,58,0.724137931
Yes,Montana,30,"Beaverhead County",30001,.,.,.,0.9677419355
Yes,Montana,30,"Big Horn County",30003,55,36,91,0.6043956044
Yes,Montana,30,"Blaine County",30005,39,14,53,0.7358490566
Yes,Montana,30,"Broadwater County",30007,.,.,.,0.82
Yes,Montana,30,"Carbon County",30009,49,12,61,0.8032786885
Yes,Montana,30,"Carter County",30011,.,0,.,1
Yes,Montana,30,"Cascade County",30013,499,158,657,0.7595129376
Yes,Montana,30,"Chouteau County",30015,.,.,.,0.8235294118
Yes,Montana,30,"Custer County",30017,89,24,113,0.7876106195
Yes,Montana,30,"Daniels County",30019,12,0,12,1
Yes,Montana,30,"Dawson County",30021,.,.,.,0.8541666667
Yes,Montana,30,"Deer Lodge County",30023,102,29,131,0.7786259542
Yes,Montana,30,"Fallon County",30025,.,.,.,0.8461538462
Yes,Montana,30,"Fergus County",30027,93,14,107,0.8691588785
Yes,Montana,30,"Flathead County",30029,514,137,651,0.7895545315
Yes,Montana,30,"Gallatin County",30031,169,46,215,0.7860465116
Yes,Montana,30,"Garfield County",30033,.,.,.,0.7
Yes,Montana,30,"Glacier County",30035,55,54,109,0.504587156
Yes,Montana,30,"Golden Valley County",30037,.,.,.,0.8571428571
Yes,Montana,30,"Granite County",30039,.,.,.,0.8695652174
Yes,Montana,30,"Hill County",30041,116,29,145,0.8
Yes,Montana,30,"Jefferson County",30043,39,20,59,0.6610169492
Yes,Montana,30,"Judith Basin County",30045,.,.,.,0.7647058824
Yes,Montana,30,"Lake County",30047,215,67,282,0.7624113475
Yes,Montana,30,"Lewis and Clark County",30049,349,92,441,0.79138322
Yes,Montana,30,"Liberty County",30051,.,.,.,0.75
Yes,Montana,30,"Lincoln County",30053,188,62,250,0.752
Yes,Montana,30,"McCone County",30055,.,.,.,0.75
Yes,Montana,30,"Madison County",30057,.,.,.,0.8518518519
Yes,Montana,30,"Meagher County",30059,.,.,.,0.7142857143
Yes,Montana,30,"Mineral County",30061,50,13,63,0.7936507937
Yes,Montana,30,"Missoula County",30063,633,175,808,0.7834158416
Yes,Montana,30,"Musselshell County",30065,47,15,62,0.7580645161
Yes,Montana,30,"Park County",30067,91,34,125,0.728
Yes,Montana,30,"Petroleum County",30069,.,0,.,1
Yes,Montana,30,"Phillips County",30071,.,.,.,0.75
Yes,Montana,30,"Pondera County",30073,48,14,62,0.7741935484
Yes,Montana,30,"Powder River County",30075,.,.,.,0.875
Yes,Montana,30,"Powell County",30077,36,14,50,0.72
Yes,Montana,30,"Prairie County",30079,.,0,.,1
Yes,Montana,30,"Ravalli County",30081,300,68,368,0.8152173913
Yes,Montana,30,"Richland County",30083,73,13,86,0.8488372093
Yes,Montana,30,"Roosevelt County",30085,47,31,78,0.6025641026
Yes,Montana,30,"Rosebud County",30087,27,21,48,0.5625
Yes,Montana,30,"Sanders County",30089,135,27,162,0.8333333333
Yes,Montana,30,"Sheridan County",30091,.,.,.,0.7777777778
Yes,Montana,30,"Silver Bow County",30093,216,75,291,0.7422680412
Yes,Montana,30,"Stillwater County",30095,.,.,.,0.8780487805
Yes,Montana,30,"Sweet Grass County",30097,.,.,.,0.8125
Yes,Montana,30,"Teton County",30099,.,.,.,0.85
Yes,Montana,30,"Toole County",30101,31,15,46,0.6739130435
Yes,Montana,30,"Treasure County",30103,.,0,.,1
Yes,Montana,30,"Valley County",30105,35,11,46,0.7608695652
Yes,Montana,30,"Wheatland County",30107,.,.,.,0.7142857143
Yes,Montana,30,"Wibaux County",30109,.,.,.,0.8
Yes,Montana,30,"Yellowstone County",30111,760,222,982,0.7739307536
Yes,Montana,30,,30999,.,.,.,0.875
Yes,Nebraska,31,"Adams County",31001,305,63,368,0.8288043478
Yes,Nebraska,31,"Antelope County",31003,57,11,68,0.8382352941
Yes,Nebraska,31,"Arthur County",31005,.,0,.,1
Yes,Nebraska,31,"Banner County",31007,.,0,.,1
Yes,Nebraska,31,"Blaine County",31009,.,0,.,1
Yes,Nebraska,31,"Boone County",31011,.,.,.,0.9
Yes,Nebraska,31,"Box Butte County",31013,89,23,112,0.7946428571
Yes,Nebraska,31,"Boyd County",31015,.,.,.,0.875
Yes,Nebraska,31,"Brown County",31017,.,.,.,0.7777777778
Yes,Nebraska,31,"Buffalo County",31019,211,64,275,0.7672727273
Yes,Nebraska,31,"Burt County",31021,45,17,62,0.7258064516
Yes,Nebraska,31,"Butler County",31023,.,.,.,0.8518518519
Yes,Nebraska,31,"Cass County",31025,101,29,130,0.7769230769
Yes,Nebraska,31,"Cedar County",31027,.,.,.,0.9272727273
Yes,Nebraska,31,"Chase County",31029,.,.,.,0.8235294118
Yes,Nebraska,31,"Cherry County",31031,.,.,.,0.8474576271
Yes,Nebraska,31,"Cheyenne County",31033,53,24,77,0.6883116883
Yes,Nebraska,31,"Clay County",31035,32,11,43,0.7441860465
Yes,Nebraska,31,"Colfax County",31037,.,.,.,0.7916666667
Yes,Nebraska,31,"Cuming County",31039,.,.,.,0.8444444444
Yes,Nebraska,31,"Custer County",31041,88,26,114,0.7719298246
Yes,Nebraska,31,"Dakota County",31043,81,29,110,0.7363636364
Yes,Nebraska,31,"Dawes County",31045,.,.,.,0.8958333333
Yes,Nebraska,31,"Dawson County",31047,132,41,173,0.7630057803
Yes,Nebraska,31,"Deuel County",31049,.,.,.,0.8333333333
Yes,Nebraska,31,"Dixon County",31051,.,.,.,0.8620689655
Yes,Nebraska,31,"Dodge County",31053,206,72,278,0.7410071942
Yes,Nebraska,31,"Douglas County",31055,2300,697,2997,0.7674341008
Yes,Nebraska,31,"Dundy County",31057,.,.,.,0.8333333333
Yes,Nebraska,31,"Fillmore County",31059,28,13,41,0.6829268293
Yes,Nebraska,31,"Franklin County",31061,.,.,.,0.8947368421
Yes,Nebraska,31,"Frontier County",31063,.,.,.,0.7777777778
Yes,Nebraska,31,"Furnas County",31065,.,.,.,0.884057971
Yes,Nebraska,31,"Gage County",31067,180,44,224,0.8035714286
Yes,Nebraska,31,"Garden County",31069,.,.,.,0.6666666667
Yes,Nebraska,31,"Garfield County",31071,.,.,.,0.8333333333
Yes,Nebraska,31,"Gosper County",31073,.,.,.,0.8333333333
Yes,Nebraska,31,"Grant County",31075,.,.,.,0.5
Yes,Nebraska,31,"Greeley County",31077,.,.,.,0.8
Yes,Nebraska,31,"Hall County",31079,372,99,471,0.7898089172
Yes,Nebraska,31,"Hamilton County",31081,43,11,54,0.7962962963
Yes,Nebraska,31,"Harlan County",31083,.,.,.,0.8684210526
Yes,Nebraska,31,"Hayes County",31085,.,.,.,0.5
Yes,Nebraska,31,"Hitchcock County",31087,.,.,.,0.8181818182
Yes,Nebraska,31,"Holt County",31089,89,36,125,0.712
Yes,Nebraska,31,"Hooker County",31091,.,.,.,0.8888888889
Yes,Nebraska,31,"Howard County",31093,45,13,58,0.775862069
Yes,Nebraska,31,"Jefferson County",31095,70,24,94,0.7446808511
Yes,Nebraska,31,"Johnson County",31097,42,11,53,0.7924528302
Yes,Nebraska,31,"Kearney County",31099,.,.,.,0.8
Yes,Nebraska,31,"Keith County",31101,67,12,79,0.8481012658
Yes,Nebraska,31,"Keya Paha County",31103,.,.,.,0.3333333333
Yes,Nebraska,31,"Kimball County",31105,33,11,44,0.75
Yes,Nebraska,31,"Knox County",31107,.,.,.,0.8837209302
Yes,Nebraska,31,"Lancaster County",31109,1433,388,1821,0.7869302581
Yes,Nebraska,31,"Lincoln County",31111,346,109,455,0.7604395604
Yes,Nebraska,31,"Logan County",31113,.,.,.,0.6666666667
Yes,Nebraska,31,"Loup County",31115,.,0,.,1
Yes,Nebraska,31,"McPherson County",31117,.,0,.,1
Yes,Nebraska,31,"Madison County",31119,238,49,287,0.8292682927
Yes,Nebraska,31,"Merrick County",31121,68,12,80,0.85
Yes,Nebraska,31,"Morrill County",31123,.,.,.,0.8163265306
Yes,Nebraska,31,"Nance County",31125,.,.,.,0.8444444444
Yes,Nebraska,31,"Nemaha County",31127,.,.,.,0.9135802469
Yes,Nebraska,31,"Nuckolls County",31129,54,12,66,0.8181818182
Yes,Nebraska,31,"Otoe County",31131,99,24,123,0.8048780488
Yes,Nebraska,31,"Pawnee County",31133,.,.,.,0.8620689655
Yes,Nebraska,31,"Perkins County",31135,.,.,.,0.8
Yes,Nebraska,31,"Phelps County",31137,98,24,122,0.8032786885
Yes,Nebraska,31,"Pierce County",31139,46,11,57,0.8070175439
Yes,Nebraska,31,"Platte County",31141,197,45,242,0.8140495868
Yes,Nebraska,31,"Polk County",31143,.,.,.,0.7619047619
Yes,Nebraska,31,"Red Willow County",31145,81,20,101,0.801980198
Yes,Nebraska,31,"Richardson County",31147,124,24,148,0.8378378378
Yes,Nebraska,31,"Rock County",31149,.,.,.,0.9
Yes,Nebraska,31,"Saline County",31151,67,16,83,0.8072289157
Yes,Nebraska,31,"Sarpy County",31153,478,126,604,0.7913907285
Yes,Nebraska,31,"Saunders County",31155,116,18,134,0.8656716418
Yes,Nebraska,31,"Scotts Bluff County",31157,297,81,378,0.7857142857
Yes,Nebraska,31,"Seward County",31159,70,18,88,0.7954545455
Yes,Nebraska,31,"Sheridan County",31161,.,.,.,0.8431372549
Yes,Nebraska,31,"Sherman County",31163,.,.,.,0.8636363636
Yes,Nebraska,31,"Sioux County",31165,.,.,.,0.5555555556
Yes,Nebraska,31,"Stanton County",31167,.,.,.,0.9642857143
Yes,Nebraska,31,"Thayer County",31169,.,.,.,0.8474576271
Yes,Nebraska,31,"Thomas County",31171,.,.,.,0.7
Yes,Nebraska,31,"Thurston County",31173,27,28,55,0.4909090909
Yes,Nebraska,31,"Valley County",31175,.,.,.,0.8
Yes,Nebraska,31,"Washington County",31177,103,25,128,0.8046875
Yes,Nebraska,31,"Wayne County",31179,.,.,.,0.9117647059
Yes,Nebraska,31,"Webster County",31181,46,15,61,0.7540983607
Yes,Nebraska,31,"Wheeler County",31183,.,.,.,0.6
Yes,Nebraska,31,"York County",31185,99,21,120,0.825
Yes,Nebraska,31,,31999,.,.,.,0.8571428571
Yes,Nevada,32,"Churchill County",32001,114,51,165,0.6909090909
Yes,Nevada,32,"Clark County",32003,7622,3629,11251,0.6774508933
Yes,Nevada,32,"Douglas County",32005,159,53,212,0.75
Yes,Nevada,32,"Elko County",32007,115,59,174,0.6609195402
Yes,Nevada,32,"Esmeralda County",32009,.,.,.,0.6666666667
Yes,Nevada,32,"Eureka County",32011,.,.,.,0.8181818182
Yes,Nevada,32,"Humboldt County",32013,78,31,109,0.7155963303
Yes,Nevada,32,"Lander County",32015,.,.,.,0.6363636364
Yes,Nevada,32,"Lincoln County",32017,.,.,.,0.9230769231
Yes,Nevada,32,"Lyon County",32019,258,108,366,0.7049180328
Yes,Nevada,32,"Mineral County",32021,45,20,65,0.6923076923
Yes,Nevada,32,"Nye County",32023,203,90,293,0.6928327645
Yes,Nevada,32,"Pershing County",32027,35,15,50,0.7
Yes,Nevada,32,"Storey County",32029,.,.,.,0.7727272727
Yes,Nevada,32,"Washoe County",32031,1404,565,1969,0.7130523108
Yes,Nevada,32,"White Pine County",32033,37,12,49,0.7551020408
Yes,Nevada,32,"Carson City",32510,289,119,408,0.7083333333
Yes,Nevada,32,,32999,.,.,.,0.7142857143
Yes,"New Hampshire",33,"Belknap County",33001,416,121,537,0.7746741155
Yes,"New Hampshire",33,"Carroll County",33003,373,85,458,0.8144104803
Yes,"New Hampshire",33,"Cheshire County",33005,494,95,589,0.8387096774
Yes,"New Hampshire",33,"Coos County",33007,488,123,611,0.798690671
Yes,"New Hampshire",33,"Grafton County",33009,557,138,695,0.8014388489
Yes,"New Hampshire",33,"Hillsborough County",33011,2081,597,2678,0.7770724421
Yes,"New Hampshire",33,"Merrimack County",33013,1029,247,1276,0.8064263323
Yes,"New Hampshire",33,"Rockingham County",33015,1241,328,1569,0.7909496495
Yes,"New Hampshire",33,"Strafford County",33017,806,255,1061,0.7596606975
Yes,"New Hampshire",33,"Sullivan County",33019,412,111,523,0.7877629063
Yes,"New Hampshire",33,,33999,.,.,.,0.7777777778
Yes,"New Jersey",34,"Atlantic County",34001,2193,705,2898,0.7567287785
Yes,"New Jersey",34,"Bergen County",34003,4549,1170,5719,0.7954187795
Yes,"New Jersey",34,"Burlington County",34005,1940,575,2515,0.7713717694
Yes,"New Jersey",34,"Camden County",34007,3767,1151,4918,0.7659617731
Yes,"New Jersey",34,"Cape May County",34009,724,210,934,0.7751605996
Yes,"New Jersey",34,"Cumberland County",34011,1346,433,1779,0.7566048342
Yes,"New Jersey",34,"Essex County",34013,4565,1830,6395,0.7138389367
Yes,"New Jersey",34,"Gloucester County",34015,1536,440,1976,0.7773279352
Yes,"New Jersey",34,"Hudson County",34017,5146,1665,6811,0.7555425048
Yes,"New Jersey",34,"Hunterdon County",34019,348,98,446,0.7802690583
Yes,"New Jersey",34,"Mercer County",34021,2298,835,3133,0.7334822853
Yes,"New Jersey",34,"Middlesex County",34023,4450,1205,5655,0.7869142352
Yes,"New Jersey",34,"Monmouth County",34025,2786,880,3666,0.7599563557
Yes,"New Jersey",34,"Morris County",34027,1775,490,2265,0.7836644592
Yes,"New Jersey",34,"Ocean County",34029,2923,862,3785,0.7722589168
Yes,"New Jersey",34,"Passaic County",34031,3799,1234,5033,0.7548181999
Yes,"New Jersey",34,"Salem County",34033,527,172,699,0.7539341917
Yes,"New Jersey",34,"Somerset County",34035,1388,354,1742,0.7967853042
Yes,"New Jersey",34,"Sussex County",34037,635,188,823,0.7715674362
Yes,"New Jersey",34,"Union County",34039,2928,1073,4001,0.7318170457
Yes,"New Jersey",34,"Warren County",34041,580,206,786,0.737913486
Yes,"New Jersey",34,,34999,39,16,55,0.7090909091
Yes,"New Mexico",35,"Bernalillo County",35001,2488,997,3485,0.7139167862
Yes,"New Mexico",35,"Catron County",35003,28,14,42,0.6666666667
Yes,"New Mexico",35,"Chaves County",35005,675,278,953,0.7082896118
Yes,"New Mexico",35,"Cibola County",35006,138,60,198,0.696969697
Yes,"New Mexico",35,"Colfax County",35007,86,40,126,0.6825396825
Yes,"New Mexico",35,"Curry County",35009,417,153,570,0.7315789474
Yes,"New Mexico",35,"DeBaca County",35011,.,.,.,0.7297297297
Yes,"New Mexico",35,"Dona Ana County",35013,1273,476,1749,0.7278444826
Yes,"New Mexico",35,"Eddy County",35015,404,183,587,0.6882453152
Yes,"New Mexico",35,"Grant County",35017,186,61,247,0.7530364372
Yes,"New Mexico",35,"Guadalupe County",35019,73,19,92,0.7934782609
Yes,"New Mexico",35,"Harding County",35021,.,.,.,0.75
Yes,"New Mexico",35,"Hidalgo County",35023,39,14,53,0.7358490566
Yes,"New Mexico",35,"Lea County",35025,534,213,747,0.7148594378
Yes,"New Mexico",35,"Lincoln County",35027,132,44,176,0.75
Yes,"New Mexico",35,"Los Alamos County",35028,.,.,.,0.72
Yes,"New Mexico",35,"Luna County",35029,280,132,412,0.6796116505
Yes,"New Mexico",35,"McKinley County",35031,261,172,433,0.6027713626
Yes,"New Mexico",35,"Mora County",35033,52,17,69,0.7536231884
Yes,"New Mexico",35,"Otero County",35035,371,151,522,0.7107279693
Yes,"New Mexico",35,"Quay County",35037,124,49,173,0.7167630058
Yes,"New Mexico",35,"Rio Arriba County",35039,210,92,302,0.6953642384
Yes,"New Mexico",35,"Roosevelt County",35041,190,94,284,0.6690140845
Yes,"New Mexico",35,"Sandoval County",35043,391,185,576,0.6788194444
Yes,"New Mexico",35,"San Juan County",35045,639,338,977,0.6540429887
Yes,"New Mexico",35,"San Miguel County",35047,232,89,321,0.722741433
Yes,"New Mexico",35,"Santa Fe County",35049,445,190,635,0.7007874016
Yes,"New Mexico",35,"Sierra County",35051,148,45,193,0.7668393782
Yes,"New Mexico",35,"Socorro County",35053,142,62,204,0.6960784314
Yes,"New Mexico",35,"Taos County",35055,216,89,305,0.7081967213
Yes,"New Mexico",35,"Torrance County",35057,105,56,161,0.652173913
Yes,"New Mexico",35,"Union County",35059,46,18,64,0.71875
Yes,"New Mexico",35,"Valencia County",35061,328,135,463,0.7084233261
Yes,"New Mexico",35,,35999,.,.,.,0.75
Yes,"New York",36,"Albany County",36001,1642,468,2110,0.7781990521
Yes,"New York",36,"Allegany County",36003,416,121,537,0.7746741155
Yes,"New York",36,"Bronx County",36005,10084,3218,13302,0.7580814915
Yes,"New York",36,"Broome County",36007,1673,431,2104,0.7951520913
Yes,"New York",36,"Cattaraugus County",36009,776,212,988,0.7854251012
Yes,"New York",36,"Cayuga County",36011,535,140,675,0.7925925926
Yes,"New York",36,"Chautauqua County",36013,1306,325,1631,0.8007357449
Yes,"New York",36,"Chemung County",36015,925,210,1135,0.8149779736
Yes,"New York",36,"Chenango County",36017,486,125,611,0.7954173486
Yes,"New York",36,"Clinton County",36019,890,253,1143,0.7786526684
Yes,"New York",36,"Columbia County",36021,533,122,655,0.813740458
Yes,"New York",36,"Cortland County",36023,330,90,420,0.7857142857
Yes,"New York",36,"Delaware County",36025,510,118,628,0.8121019108
Yes,"New York",36,"Dutchess County",36027,1796,498,2294,0.7829119442
Yes,"New York",36,"Erie County",36029,4840,1594,6434,0.7522536525
Yes,"New York",36,"Essex County",36031,357,99,456,0.7828947368
Yes,"New York",36,"Franklin County",36033,639,132,771,0.8287937743
Yes,"New York",36,"Fulton County",36035,561,150,711,0.7890295359
Yes,"New York",36,"Genesee County",36037,427,91,518,0.8243243243
Yes,"New York",36,"Greene County",36039,454,116,570,0.7964912281
Yes,"New York",36,"Hamilton County",36041,36,11,47,0.7659574468
Yes,"New York",36,"Herkimer County",36043,623,130,753,0.8273572377
Yes,"New York",36,"Jefferson County",36045,871,202,1073,0.8117427773
Yes,"New York",36,"Kings County",36047,30701,8726,39427,0.7786795851
Yes,"New York",36,"Lewis County",36049,245,49,294,0.8333333333
Yes,"New York",36,"Livingston County",36051,386,91,477,0.8092243187
Yes,"New York",36,"Madison County",36053,414,81,495,0.8363636364
Yes,"New York",36,"Monroe County",36055,4676,1474,6150,0.7603252033
Yes,"New York",36,"Montgomery County",36057,542,160,702,0.7720797721
Yes,"New York",36,"Nassau County",36059,6908,2207,9115,0.7578716402
Yes,"New York",36,"New York County",36061,11815,3374,15189,0.7778655606
Yes,"New York",36,"Niagara County",36063,1222,344,1566,0.7803320562
Yes,"New York",36,"Oneida County",36065,2074,562,2636,0.7867981791
Yes,"New York",36,"Onondaga County",36067,2598,807,3405,0.7629955947
Yes,"New York",36,"Ontario County",36069,593,168,761,0.7792378449
Yes,"New York",36,"Orange County",36071,2226,824,3050,0.7298360656
Yes,"New York",36,"Orleans County",36073,317,119,436,0.7270642202
Yes,"New York",36,"Oswego County",36075,841,221,1062,0.7919020716
Yes,"New York",36,"Otsego County",36077,573,135,708,0.8093220339
Yes,"New York",36,"Putnam County",36079,393,119,512,0.767578125
Yes,"New York",36,"Queens County",36081,18448,5335,23783,0.7756801076
Yes,"New York",36,"Rensselaer County",36083,890,273,1163,0.7652622528
Yes,"New York",36,"Richmond County",36085,3498,938,4436,0.7885482417
Yes,"New York",36,"Rockland County",36087,2106,570,2676,0.7869955157
Yes,"New York",36,"St. Lawrence County",36089,1187,300,1487,0.7982515131
Yes,"New York",36,"Saratoga County",36091,960,243,1203,0.7980049875
Yes,"New York",36,"Schenectady County",36093,971,273,1244,0.7805466238
Yes,"New York",36,"Schoharie County",36095,318,67,385,0.825974026
Yes,"New York",36,"Schuyler County",36097,199,53,252,0.7896825397
Yes,"New York",36,"Seneca County",36099,285,63,348,0.8189655172
Yes,"New York",36,"Steuben County",36101,949,225,1174,0.8083475298
Yes,"New York",36,"Suffolk County",36103,8960,3004,11964,0.7489134069
Yes,"New York",36,"Sullivan County",36105,785,267,1052,0.7461977186
Yes,"New York",36,"Tioga County",36107,400,87,487,0.8213552361
Yes,"New York",36,"Tompkins County",36109,437,153,590,0.7406779661
Yes,"New York",36,"Ulster County",36111,1518,429,1947,0.7796610169
Yes,"New York",36,"Warren County",36113,531,152,683,0.7774524158
Yes,"New York",36,"Washington County",36115,474,108,582,0.8144329897
Yes,"New York",36,"Wayne County",36117,810,209,1019,0.7948969578
Yes,"New York",36,"Westchester County",36119,5304,1678,6982,0.759667717
Yes,"New York",36,"Wyoming County",36121,237,67,304,0.7796052632
Yes,"New York",36,"Yates County",36123,187,49,236,0.7923728814
Yes,"New York",36,,36999,111,33,144,0.7708333333
Yes,"North Carolina",37,"Alamance County",37001,1000,304,1304,0.7668711656
Yes,"North Carolina",37,"Alexander County",37003,290,111,401,0.72319202
Yes,"North Carolina",37,"Alleghany County",37005,156,37,193,0.8082901554
Yes,"North Carolina",37,"Anson County",37007,377,132,509,0.7406679764
Yes,"North Carolina",37,"Ashe County",37009,389,98,487,0.7987679671
Yes,"North Carolina",37,"Avery County",37011,213,40,253,0.8418972332
Yes,"North Carolina",37,"Beaufort County",37013,659,223,882,0.7471655329
Yes,"North Carolina",37,"Bertie County",37015,439,173,612,0.7173202614
Yes,"North Carolina",37,"Bladen County",37017,577,203,780,0.7397435897
Yes,"North Carolina",37,"Brunswick County",37019,891,274,1165,0.764806867
Yes,"North Carolina",37,"Buncombe County",37021,1807,550,2357,0.7666525244
Yes,"North Carolina",37,"Burke County",37023,851,235,1086,0.7836095764
Yes,"North Carolina",37,"Cabarrus County",37025,982,289,1271,0.7726199843
Yes,"North Carolina",37,"Caldwell County",37027,816,272,1088,0.75
Yes,"North Carolina",37,"Camden County",37029,59,22,81,0.7283950617
Yes,"North Carolina",37,"Carteret County",37031,556,153,709,0.784203103
Yes,"North Carolina",37,"Caswell County",37033,275,74,349,0.787965616
Yes,"North Carolina",37,"Catawba County",37035,1047,330,1377,0.7603485839
Yes,"North Carolina",37,"Chatham County",37037,324,92,416,0.7788461538
Yes,"North Carolina",37,"Cherokee County",37039,436,114,550,0.7927272727
Yes,"North Carolina",37,"Chowan County",37041,206,73,279,0.7383512545
Yes,"North Carolina",37,"Clay County",37043,144,32,176,0.8181818182
Yes,"North Carolina",37,"Cleveland County",37045,1187,364,1551,0.7653127015
Yes,"North Carolina",37,"Columbus County",37047,934,393,1327,0.7038432555
Yes,"North Carolina",37,"Craven County",37049,730,245,975,0.7487179487
Yes,"North Carolina",37,"Cumberland County",37051,2224,948,3172,0.7011349306
Yes,"North Carolina",37,"Currituck County",37053,132,38,170,0.7764705882
Yes,"North Carolina",37,"Dare County",37055,171,30,201,0.8507462687
Yes,"North Carolina",37,"Davidson County",37057,1101,340,1441,0.7640527412
Yes,"North Carolina",37,"Davie County",37059,212,78,290,0.7310344828
Yes,"North Carolina",37,"Duplin County",37061,766,262,1028,0.7451361868
Yes,"North Carolina",37,"Durham County",37063,1327,511,1838,0.7219804135
Yes,"North Carolina",37,"Edgecombe County",37065,1001,385,1386,0.7222222222
Yes,"North Carolina",37,"Forsyth County",37067,1736,652,2388,0.7269681742
Yes,"North Carolina",37,"Franklin County",37069,480,184,664,0.7228915663
Yes,"North Carolina",37,"Gaston County",37071,1771,577,2348,0.7542589438
Yes,"North Carolina",37,"Gates County",37073,116,48,164,0.7073170732
Yes,"North Carolina",37,"Graham County",37075,133,43,176,0.7556818182
Yes,"North Carolina",37,"Granville County",37077,566,177,743,0.7617765814
Yes,"North Carolina",37,"Greene County",37079,213,84,297,0.7171717172
Yes,"North Carolina",37,"Guilford County",37081,2505,915,3420,0.7324561404
Yes,"North Carolina",37,"Halifax County",37083,1127,392,1519,0.7419354839
Yes,"North Carolina",37,"Harnett County",37085,1088,421,1509,0.7210072896
Yes,"North Carolina",37,"Haywood County",37087,653,177,830,0.786746988
Yes,"North Carolina",37,"Henderson County",37089,715,203,918,0.7788671024
Yes,"North Carolina",37,"Hertford County",37091,407,166,573,0.7102966841
Yes,"North Carolina",37,"Hoke County",37093,414,178,592,0.6993243243
Yes,"North Carolina",37,"Hyde County",37095,81,23,104,0.7788461538
Yes,"North Carolina",37,"Iredell County",37097,915,340,1255,0.7290836653
Yes,"North Carolina",37,"Jackson County",37099,301,103,404,0.745049505
Yes,"North Carolina",37,"Johnston County",37101,1600,588,2188,0.731261426
Yes,"North Carolina",37,"Jones County",37103,172,52,224,0.7678571429
Yes,"North Carolina",37,"Lee County",37105,576,204,780,0.7384615385
Yes,"North Carolina",37,"Lenoir County",37107,899,404,1303,0.6899462778
Yes,"North Carolina",37,"Lincoln County",37109,642,192,834,0.7697841727
Yes,"North Carolina",37,"McDowell County",37111,614,191,805,0.7627329193
Yes,"North Carolina",37,"Macon County",37113,422,130,552,0.7644927536
Yes,"North Carolina",37,"Madison County",37115,298,70,368,0.8097826087
Yes,"North Carolina",37,"Martin County",37117,400,190,590,0.6779661017
Yes,"North Carolina",37,"Mecklenburg County",37119,4040,1480,5520,0.731884058
Yes,"North Carolina",37,"Mitchell County",37121,216,50,266,0.8120300752
Yes,"North Carolina",37,"Montgomery County",37123,352,83,435,0.8091954023
Yes,"North Carolina",37,"Moore County",37125,637,215,852,0.7476525822
Yes,"North Carolina",37,"Nash County",37127,1166,390,1556,0.7493573265
Yes,"North Carolina",37,"New Hanover County",37129,1257,413,1670,0.7526946108
Yes,"North Carolina",37,"Northampton County",37131,386,145,531,0.7269303202
Yes,"North Carolina",37,"Onslow County",37133,1027,348,1375,0.7469090909
Yes,"North Carolina",37,"Orange County",37135,438,133,571,0.7670753065
Yes,"North Carolina",37,"Pamlico County",37137,175,48,223,0.7847533632
Yes,"North Carolina",37,"Pasquotank County",37139,414,168,582,0.7113402062
Yes,"North Carolina",37,"Pender County",37141,543,171,714,0.7605042017
Yes,"North Carolina",37,"Perquimans County",37143,128,60,188,0.6808510638
Yes,"North Carolina",37,"Person County",37145,375,154,529,0.7088846881
Yes,"North Carolina",37,"Pitt County",37147,1643,684,2327,0.7060593038
Yes,"North Carolina",37,"Polk County",37149,152,42,194,0.7835051546
Yes,"North Carolina",37,"Randolph County",37151,988,324,1312,0.7530487805
Yes,"North Carolina",37,"Richmond County",37153,709,273,982,0.7219959267
Yes,"North Carolina",37,"Robeson County",37155,2213,791,3004,0.7366844208
Yes,"North Carolina",37,"Rockingham County",37157,838,273,1111,0.7542754275
Yes,"North Carolina",37,"Rowan County",37159,937,361,1298,0.7218798151
Yes,"North Carolina",37,"Rutherford County",37161,833,250,1083,0.7691597415
Yes,"North Carolina",37,"Sampson County",37163,906,314,1220,0.7426229508
Yes,"North Carolina",37,"Scotland County",37165,583,217,800,0.72875
Yes,"North Carolina",37,"Stanly County",37167,633,192,825,0.7672727273
Yes,"North Carolina",37,"Stokes County",37169,350,84,434,0.8064516129
Yes,"North Carolina",37,"Surry County",37171,814,243,1057,0.7701040681
Yes,"North Carolina",37,"Swain County",37173,187,76,263,0.711026616
Yes,"North Carolina",37,"Transylvania County",37175,272,74,346,0.7861271676
Yes,"North Carolina",37,"Tyrrell County",37177,69,11,80,0.8625
Yes,"North Carolina",37,"Union County",37179,890,284,1174,0.7580919932
Yes,"North Carolina",37,"Vance County",37181,585,249,834,0.7014388489
Yes,"North Carolina",37,"Wake County",37183,3240,1134,4374,0.7407407407
Yes,"North Carolina",37,"Warren County",37185,302,123,425,0.7105882353
Yes,"North Carolina",37,"Washington County",37187,186,86,272,0.6838235294
Yes,"North Carolina",37,"Watauga County",37189,273,72,345,0.7913043478
Yes,"North Carolina",37,"Wayne County",37191,1253,562,1815,0.6903581267
Yes,"North Carolina",37,"Wilkes County",37193,837,230,1067,0.7844423618
Yes,"North Carolina",37,"Wilson County",37195,1059,408,1467,0.7218813906
Yes,"North Carolina",37,"Yadkin County",37197,289,88,377,0.7665782493
Yes,"North Carolina",37,"Yancey County",37199,233,61,294,0.7925170068
Yes,"North Carolina",37,,37999,80,34,114,0.701754386
Yes,"North Dakota",38,"Adams County",38001,.,.,.,0.72
Yes,"North Dakota",38,"Barnes County",38003,72,13,85,0.8470588235
Yes,"North Dakota",38,"Benson County",38005,40,26,66,0.6060606061
Yes,"North Dakota",38,"Billings County",38007,.,0,.,1
Yes,"North Dakota",38,"Bottineau County",38009,28,12,40,0.7
Yes,"North Dakota",38,"Bowman County",38011,.,.,.,0.9615384615
Yes,"North Dakota",38,"Burke County",38013,.,.,.,0.5
Yes,"North Dakota",38,"Burleigh County",38015,386,73,459,0.8409586057
Yes,"North Dakota",38,"Cass County",38017,655,135,790,0.8291139241
Yes,"North Dakota",38,"Cavalier County",38019,.,.,.,0.8260869565
Yes,"North Dakota",38,"Dickey County",38021,.,.,.,0.9069767442
Yes,"North Dakota",38,"Divide County",38023,.,.,.,0.8181818182
Yes,"North Dakota",38,"Dunn County",38025,.,.,.,0.8709677419
Yes,"North Dakota",38,"Eddy County",38027,.,.,.,0.7619047619
Yes,"North Dakota",38,"Emmons County",38029,.,.,.,0.8571428571
Yes,"North Dakota",38,"Foster County",38031,.,.,.,0.9117647059
Yes,"North Dakota",38,"Golden Valley County",38033,.,.,.,0.7333333333
Yes,"North Dakota",38,"Grand Forks County",38035,337,65,402,0.8383084577
Yes,"North Dakota",38,"Grant County",38037,.,.,.,0.8157894737
Yes,"North Dakota",38,"Griggs County",38039,.,.,.,0.724137931
Yes,"North Dakota",38,"Hettinger County",38041,.,.,.,0.9333333333
Yes,"North Dakota",38,"Kidder County",38043,.,.,.,0.7916666667
Yes,"North Dakota",38,"LaMoure County",38045,.,.,.,0.7368421053
Yes,"North Dakota",38,"Logan County",38047,.,.,.,0.8888888889
Yes,"North Dakota",38,"McHenry County",38049,32,12,44,0.7272727273
Yes,"North Dakota",38,"McIntosh County",38051,.,.,.,0.7894736842
Yes,"North Dakota",38,"McKenzie County",38053,.,.,.,0.8461538462
Yes,"North Dakota",38,"McLean County",38055,.,.,.,0.8448275862
Yes,"North Dakota",38,"Mercer County",38057,.,.,.,0.88
Yes,"North Dakota",38,"Morton County",38059,179,37,216,0.8287037037
Yes,"North Dakota",38,"Mountrail County",38061,17,12,29,0.5862068966
Yes,"North Dakota",38,"Nelson County",38063,.,.,.,0.8235294118
Yes,"North Dakota",38,"Oliver County",38065,.,.,.,0.8461538462
Yes,"North Dakota",38,"Pembina County",38067,.,.,.,0.890625
Yes,"North Dakota",38,"Pierce County",38069,.,.,.,0.8571428571
Yes,"North Dakota",38,"Ramsey County",38071,120,28,148,0.8108108108
Yes,"North Dakota",38,"Ransom County",38073,.,.,.,0.8888888889
Yes,"North Dakota",38,"Renville County",38075,.,.,.,0.8
Yes,"North Dakota",38,"Richland County",38077,104,13,117,0.8888888889
Yes,"North Dakota",38,"Rolette County",38079,104,41,145,0.7172413793
Yes,"North Dakota",38,"Sargent County",38081,.,.,.,0.9230769231
Yes,"North Dakota",38,"Sheridan County",38083,.,.,.,0.7857142857
Yes,"North Dakota",38,"Sioux County",38085,.,.,.,0.6428571429
Yes,"North Dakota",38,"Slope County",38087,.,.,.,0.8
Yes,"North Dakota",38,"Stark County",38089,173,28,201,0.8606965174
Yes,"North Dakota",38,"Steele County",38091,.,.,.,0.75
Yes,"North Dakota",38,"Stutsman County",38093,178,38,216,0.8240740741
Yes,"North Dakota",38,"Towner County",38095,.,.,.,0.8571428571
Yes,"North Dakota",38,"Traill County",38097,.,.,.,0.875
Yes,"North Dakota",38,"Walsh County",38099,107,25,132,0.8106060606
Yes,"North Dakota",38,"Ward County",38101,260,71,331,0.7854984894
Yes,"North Dakota",38,"Wells County",38103,.,.,.,0.7777777778
Yes,"North Dakota",38,"Williams County",38105,89,26,115,0.7739130435
Yes,"North Dakota",38,,38999,0,.,.,0
Yes,Ohio,39,"Adams County",39001,401,166,567,0.7072310406
Yes,Ohio,39,"Allen County",39003,1003,315,1318,0.7610015175
Yes,Ohio,39,"Ashland County",39005,323,88,411,0.7858880779
Yes,Ohio,39,"Ashtabula County",39007,1181,279,1460,0.8089041096
Yes,Ohio,39,"Athens County",39009,553,176,729,0.7585733882
Yes,Ohio,39,"Auglaize County",39011,301,55,356,0.845505618
Yes,Ohio,39,"Belmont County",39013,594,150,744,0.7983870968
Yes,Ohio,39,"Brown County",39015,405,136,541,0.7486136784
Yes,Ohio,39,"Butler County",39017,1784,603,2387,0.7473816506
Yes,Ohio,39,"Carroll County",39019,190,28,218,0.871559633
Yes,Ohio,39,"Champaign County",39021,282,66,348,0.8103448276
Yes,Ohio,39,"Clark County",39023,1022,333,1355,0.7542435424
Yes,Ohio,39,"Clermont County",39025,945,262,1207,0.7829328915
Yes,Ohio,39,"Clinton County",39027,302,85,387,0.7803617571
Yes,Ohio,39,"Columbiana County",39029,853,259,1112,0.7670863309
Yes,Ohio,39,"Coshocton County",39031,490,88,578,0.8477508651
Yes,Ohio,39,"Crawford County",39033,454,135,589,0.7707979626
Yes,Ohio,39,"Cuyahoga County",39035,9402,3081,12483,0.7531843307
Yes,Ohio,39,"Darke County",39037,319,86,405,0.787654321
Yes,Ohio,39,"Defiance County",39039,320,91,411,0.7785888078
Yes,Ohio,39,"Delaware County",39041,461,101,562,0.8202846975
Yes,Ohio,39,"Erie County",39043,521,197,718,0.7256267409
Yes,Ohio,39,"Fairfield County",39045,840,265,1105,0.7601809955
Yes,Ohio,39,"Fayette County",39047,257,103,360,0.7138888889
Yes,Ohio,39,"Franklin County",39049,5725,2134,7859,0.7284641812
Yes,Ohio,39,"Fulton County",39051,221,63,284,0.7781690141
Yes,Ohio,39,"Gallia County",39053,408,150,558,0.7311827957
Yes,Ohio,39,"Geauga County",39055,354,66,420,0.8428571429
Yes,Ohio,39,"Greene County",39057,664,200,864,0.7685185185
Yes,Ohio,39,"Guernsey County",39059,564,140,704,0.8011363636
Yes,Ohio,39,"Hamilton County",39061,4314,1596,5910,0.7299492386
Yes,Ohio,39,"Hancock County",39063,404,110,514,0.7859922179
Yes,Ohio,39,"Hardin County",39065,252,75,327,0.7706422018
Yes,Ohio,39,"Harrison County",39067,172,47,219,0.7853881279
Yes,Ohio,39,"Henry County",39069,201,46,247,0.8137651822
Yes,Ohio,39,"Highland County",39071,497,163,660,0.753030303
Yes,Ohio,39,"Hocking County",39073,327,98,425,0.7694117647
Yes,Ohio,39,"Holmes County",39075,142,35,177,0.802259887
Yes,Ohio,39,"Huron County",39077,460,117,577,0.7972270364
Yes,Ohio,39,"Jackson County",39079,504,159,663,0.7601809955
Yes,Ohio,39,"Jefferson County",39081,720,255,975,0.7384615385
Yes,Ohio,39,"Knox County",39083,470,121,591,0.7952622673
Yes,Ohio,39,"Lake County",39085,1080,302,1382,0.7814761216
Yes,Ohio,39,"Lawrence County",39087,948,342,1290,0.7348837209
Yes,Ohio,39,"Licking County",39089,1006,292,1298,0.7750385208
Yes,Ohio,39,"Logan County",39091,395,100,495,0.797979798
Yes,Ohio,39,"Lorain County",39093,1884,581,2465,0.7643002028
Yes,Ohio,39,"Lucas County",39095,3468,1230,4698,0.7381864623
Yes,Ohio,39,"Madison County",39097,229,89,318,0.7201257862
Yes,Ohio,39,"Mahoning County",39099,1672,528,2200,0.76
Yes,Ohio,39,"Marion County",39101,640,225,865,0.7398843931
Yes,Ohio,39,"Medina County",39103,598,138,736,0.8125
Yes,Ohio,39,"Meigs County",39105,333,117,450,0.74
Yes,Ohio,39,"Mercer County",39107,296,70,366,0.8087431694
Yes,Ohio,39,"Miami County",39109,597,175,772,0.7733160622
Yes,Ohio,39,"Monroe County",39111,140,46,186,0.752688172
Yes,Ohio,39,"Montgomery County",39113,3001,1195,4196,0.7152049571
Yes,Ohio,39,"Morgan County",39115,184,49,233,0.7896995708
Yes,Ohio,39,"Morrow County",39117,284,65,349,0.8137535817
Yes,Ohio,39,"Muskingum County",39119,1295,359,1654,0.7829504232
Yes,Ohio,39,"Noble County",39121,136,34,170,0.8
Yes,Ohio,39,"Ottawa County",39123,240,73,313,0.7667731629
Yes,Ohio,39,"Paulding County",39125,158,34,192,0.8229166667
Yes,Ohio,39,"Perry County",39127,459,128,587,0.7819420784
Yes,Ohio,39,"Pickaway County",39129,333,107,440,0.7568181818
Yes,Ohio,39,"Pike County",39131,467,131,598,0.7809364548
Yes,Ohio,39,"Portage County",39133,697,176,873,0.7983963345
Yes,Ohio,39,"Preble County",39135,318,70,388,0.8195876289
Yes,Ohio,39,"Putnam County",39137,225,45,270,0.8333333333
Yes,Ohio,39,"Richland County",39139,1211,332,1543,0.7848347375
Yes,Ohio,39,"Ross County",39141,824,249,1073,0.7679403541
Yes,Ohio,39,"Sandusky County",39143,444,128,572,0.7762237762
Yes,Ohio,39,"Scioto County",39145,1433,509,1942,0.7378990731
Yes,Ohio,39,"Seneca County",39147,503,124,627,0.8022328549
Yes,Ohio,39,"Shelby County",39149,281,74,355,0.7915492958
Yes,Ohio,39,"Stark County",39151,2281,676,2957,0.7713899222
Yes,Ohio,39,"Summit County",39153,3058,819,3877,0.7887541914
Yes,Ohio,39,"Trumbull County",39155,1449,473,1922,0.7539021852
Yes,Ohio,39,"Tuscarawas County",39157,747,185,932,0.8015021459
Yes,Ohio,39,"Union County",39159,219,56,275,0.7963636364
Yes,Ohio,39,"Van Wert County",39161,239,66,305,0.7836065574
Yes,Ohio,39,"Vinton County",39163,186,55,241,0.7717842324
Yes,Ohio,39,"Warren County",39165,678,226,904,0.75
Yes,Ohio,39,"Washington County",39167,725,194,919,0.7889009793
Yes,Ohio,39,"Wayne County",39169,653,156,809,0.8071693449
Yes,Ohio,39,"Williams County",39171,287,64,351,0.8176638177
Yes,Ohio,39,"Wood County",39173,591,156,747,0.7911646586
Yes,Ohio,39,"Wyandot County",39175,168,47,215,0.7813953488
Yes,Ohio,39,,39999,65,23,88,0.7386363636
Yes,Oklahoma,40,"Adair County",40001,235,100,335,0.7014925373
Yes,Oklahoma,40,"Alfalfa County",40003,30,14,44,0.6818181818
Yes,Oklahoma,40,"Atoka County",40005,172,77,249,0.6907630522
Yes,Oklahoma,40,"Beaver County",40007,.,.,.,0.8095238095
Yes,Oklahoma,40,"Beckham County",40009,143,50,193,0.7409326425
Yes,Oklahoma,40,"Blaine County",40011,71,35,106,0.6698113208
Yes,Oklahoma,40,"Bryan County",40013,407,220,627,0.649122807
Yes,Oklahoma,40,"Caddo County",40015,216,107,323,0.6687306502
Yes,Oklahoma,40,"Canadian County",40017,395,158,553,0.7142857143
Yes,Oklahoma,40,"Carter County",40019,473,183,656,0.7210365854
Yes,Oklahoma,40,"Cherokee County",40021,361,187,548,0.6587591241
Yes,Oklahoma,40,"Choctaw County",40023,241,122,363,0.6639118457
Yes,Oklahoma,40,"Cimarron County",40025,.,.,.,0.935483871
Yes,Oklahoma,40,"Cleveland County",40027,976,359,1335,0.7310861423
Yes,Oklahoma,40,"Coal County",40029,78,30,108,0.7222222222
Yes,Oklahoma,40,"Comanche County",40031,616,292,908,0.6784140969
Yes,Oklahoma,40,"Cotton County",40033,36,19,55,0.6545454545
Yes,Oklahoma,40,"Craig County",40035,138,51,189,0.7301587302
Yes,Oklahoma,40,"Creek County",40037,527,208,735,0.7170068027
Yes,Oklahoma,40,"Custer County",40039,146,72,218,0.6697247706
Yes,Oklahoma,40,"Delaware County",40041,375,171,546,0.6868131868
Yes,Oklahoma,40,"Dewey County",40043,27,20,47,0.5744680851
Yes,Oklahoma,40,"Ellis County",40045,.,.,.,0.8048780488
Yes,Oklahoma,40,"Garfield County",40047,422,163,585,0.7213675214
Yes,Oklahoma,40,"Garvin County",40049,243,89,332,0.7319277108
Yes,Oklahoma,40,"Grady County",40051,349,120,469,0.7441364606
Yes,Oklahoma,40,"Grant County",40053,42,11,53,0.7924528302
Yes,Oklahoma,40,"Greer County",40055,67,37,104,0.6442307692
Yes,Oklahoma,40,"Harmon County",40057,60,19,79,0.7594936709
Yes,Oklahoma,40,"Harper County",40059,24,11,35,0.6857142857
Yes,Oklahoma,40,"Haskell County",40061,168,53,221,0.7601809955
Yes,Oklahoma,40,"Hughes County",40063,144,64,208,0.6923076923
Yes,Oklahoma,40,"Jackson County",40065,190,81,271,0.7011070111
Yes,Oklahoma,40,"Jefferson County",40067,89,32,121,0.7355371901
Yes,Oklahoma,40,"Johnston County",40069,151,66,217,0.6958525346
Yes,Oklahoma,40,"Kay County",40071,373,196,569,0.6555360281
Yes,Oklahoma,40,"Kingfisher County",40073,88,27,115,0.7652173913
Yes,Oklahoma,40,"Kiowa County",40075,131,51,182,0.7197802198
Yes,Oklahoma,40,"Latimer County",40077,149,59,208,0.7163461538
Yes,Oklahoma,40,"Le Flore County",40079,699,269,968,0.722107438
Yes,Oklahoma,40,"Lincoln County",40081,282,112,394,0.7157360406
Yes,Oklahoma,40,"Logan County",40083,241,68,309,0.7799352751
Yes,Oklahoma,40,"Love County",40085,86,44,130,0.6615384615
Yes,Oklahoma,40,"McClain County",40087,201,95,296,0.6790540541
Yes,Oklahoma,40,"McCurtain County",40089,488,264,752,0.6489361702
Yes,Oklahoma,40,"McIntosh County",40091,251,115,366,0.6857923497
Yes,Oklahoma,40,"Major County",40093,43,22,65,0.6615384615
Yes,Oklahoma,40,"Marshall County",40095,141,78,219,0.6438356164
Yes,Oklahoma,40,"Mayes County",40097,296,153,449,0.6592427617
Yes,Oklahoma,40,"Murray County",40099,148,60,208,0.7115384615
Yes,Oklahoma,40,"Muskogee County",40101,722,338,1060,0.6811320755
Yes,Oklahoma,40,"Noble County",40103,109,39,148,0.7364864865
Yes,Oklahoma,40,"Nowata County",40105,93,38,131,0.7099236641
Yes,Oklahoma,40,"Okfuskee County",40107,182,53,235,0.7744680851
Yes,Oklahoma,40,"Oklahoma County",40109,3807,1675,5482,0.6944545786
Yes,Oklahoma,40,"Okmulgee County",40111,448,189,637,0.7032967033
Yes,Oklahoma,40,"Osage County",40113,353,133,486,0.7263374486
Yes,Oklahoma,40,"Ottawa County",40115,375,150,525,0.7142857143
Yes,Oklahoma,40,"Pawnee County",40117,148,67,215,0.688372093
Yes,Oklahoma,40,"Payne County",40119,458,196,654,0.7003058104
Yes,Oklahoma,40,"Pittsburg County",40121,480,212,692,0.6936416185
Yes,Oklahoma,40,"Pontotoc County",40123,378,151,529,0.7145557656
Yes,Oklahoma,40,"Pottawatomie County",40125,584,244,828,0.7053140097
Yes,Oklahoma,40,"Pushmataha County",40127,164,97,261,0.6283524904
Yes,Oklahoma,40,"Roger Mills County",40129,.,.,.,0.6923076923
Yes,Oklahoma,40,"Rogers County",40131,406,193,599,0.6777963272
Yes,Oklahoma,40,"Seminole County",40133,326,159,485,0.6721649485
Yes,Oklahoma,40,"Sequoyah County",40135,571,288,859,0.6647264261
Yes,Oklahoma,40,"Stephens County",40137,429,170,599,0.7161936561
Yes,Oklahoma,40,"Texas County",40139,83,37,120,0.6916666667
Yes,Oklahoma,40,"Tillman County",40141,104,50,154,0.6753246753
Yes,Oklahoma,40,"Tulsa County",40143,2911,1456,4367,0.6665903366
Yes,Oklahoma,40,"Wagoner County",40145,345,176,521,0.6621880998
Yes,Oklahoma,40,"Washington County",40147,425,158,583,0.7289879931
Yes,Oklahoma,40,"Washita County",40149,82,35,117,0.7008547009
Yes,Oklahoma,40,"Woods County",40151,44,16,60,0.7333333333
Yes,Oklahoma,40,"Woodward County",40153,125,43,168,0.744047619
Yes,Oklahoma,40,,40999,.,.,.,0.7297297297
Yes,Oregon,41,"Baker County",41001,134,34,168,0.7976190476
Yes,Oregon,41,"Benton County",41003,235,79,314,0.7484076433
Yes,Oregon,41,"Clackamas County",41005,936,274,1210,0.773553719
Yes,Oregon,41,"Clatsop County",41007,348,83,431,0.807424594
Yes,Oregon,41,"Columbia County",41009,258,79,337,0.765578635
Yes,Oregon,41,"Coos County",41011,944,271,1215,0.7769547325
Yes,Oregon,41,"Crook County",41013,151,52,203,0.7438423645
Yes,Oregon,41,"Curry County",41015,319,96,415,0.7686746988
Yes,Oregon,41,"Deschutes County",41017,635,211,846,0.7505910165
Yes,Oregon,41,"Douglas County",41019,862,295,1157,0.7450302506
Yes,Oregon,41,"Gilliam County",41021,.,.,.,0.8333333333
Yes,Oregon,41,"Grant County",41023,74,23,97,0.7628865979
Yes,Oregon,41,"Harney County",41025,68,25,93,0.7311827957
Yes,Oregon,41,"Hood River County",41027,85,18,103,0.8252427184
Yes,Oregon,41,"Jackson County",41029,1410,478,1888,0.7468220339
Yes,Oregon,41,"Jefferson County",41031,138,52,190,0.7263157895
Yes,Oregon,41,"Josephine County",41033,798,255,1053,0.7578347578
Yes,Oregon,41,"Klamath County",41035,518,183,701,0.7389443652
Yes,Oregon,41,"Lake County",41037,76,31,107,0.7102803738
Yes,Oregon,41,"Lane County",41039,2035,673,2708,0.7514771049
Yes,Oregon,41,"Lincoln County",41041,540,149,689,0.7837445573
Yes,Oregon,41,"Linn County",41043,770,223,993,0.775427996
Yes,Oregon,41,"Malheur County",41045,285,78,363,0.7851239669
Yes,Oregon,41,"Marion County",41047,1452,469,1921,0.7558563248
Yes,Oregon,41,"Morrow County",41049,66,39,105,0.6285714286
Yes,Oregon,41,"Multnomah County",41051,2874,980,3854,0.7457187338
Yes,Oregon,41,"Polk County",41053,320,107,427,0.7494145199
Yes,Oregon,41,"Sherman County",41055,.,.,.,0.7727272727
Yes,Oregon,41,"Tillamook County",41057,232,75,307,0.7557003257
Yes,Oregon,41,"Umatilla County",41059,634,210,844,0.7511848341
Yes,Oregon,41,"Union County",41061,221,69,290,0.7620689655
Yes,Oregon,41,"Wallowa County",41063,60,16,76,0.7894736842
Yes,Oregon,41,"Wasco County",41065,256,66,322,0.7950310559
Yes,Oregon,41,"Washington County",41067,1535,451,1986,0.7729103726
Yes,Oregon,41,"Wheeler County",41069,.,.,.,0.9047619048
Yes,Oregon,41,"Yamhill County",41071,493,162,655,0.7526717557
Yes,Oregon,41,,41999,.,.,.,0.64
Yes,Pennsylvania,42,"Adams County",42001,519,134,653,0.7947932619
Yes,Pennsylvania,42,"Allegheny County",42003,4076,1274,5350,0.7618691589
Yes,Pennsylvania,42,"Armstrong County",42005,355,89,444,0.7995495495
Yes,Pennsylvania,42,"Beaver County",42007,622,203,825,0.7539393939
Yes,Pennsylvania,42,"Bedford County",42009,419,102,521,0.8042226488
Yes,Pennsylvania,42,"Berks County",42011,2524,643,3167,0.7969687401
Yes,Pennsylvania,42,"Blair County",42013,1013,281,1294,0.7828438949
Yes,Pennsylvania,42,"Bradford County",42015,592,140,732,0.8087431694
Yes,Pennsylvania,42,"Bucks County",42017,2770,677,3447,0.803597331
Yes,Pennsylvania,42,"Butler County",42019,526,149,675,0.7792592593
Yes,Pennsylvania,42,"Cambria County",42021,1087,236,1323,0.8216175359
Yes,Pennsylvania,42,"Cameron County",42023,60,28,88,0.6818181818
Yes,Pennsylvania,42,"Carbon County",42025,560,129,689,0.8127721335
Yes,Pennsylvania,42,"Centre County",42027,571,116,687,0.8311499272
Yes,Pennsylvania,42,"Chester County",42029,1615,457,2072,0.7794401544
Yes,Pennsylvania,42,"Clarion County",42031,382,70,452,0.8451327434
Yes,Pennsylvania,42,"Clearfield County",42033,867,240,1107,0.783197832
Yes,Pennsylvania,42,"Clinton County",42035,388,64,452,0.8584070796
Yes,Pennsylvania,42,"Columbia County",42037,511,104,615,0.8308943089
Yes,Pennsylvania,42,"Crawford County",42039,885,209,1094,0.8089579525
Yes,Pennsylvania,42,"Cumberland County",42041,949,224,1173,0.8090366581
Yes,Pennsylvania,42,"Dauphin County",42043,1360,441,1801,0.7551360355
Yes,Pennsylvania,42,"Delaware County",42045,2980,892,3872,0.7696280992
Yes,Pennsylvania,42,"Elk County",42047,299,56,355,0.8422535211
Yes,Pennsylvania,42,"Erie County",42049,1830,561,2391,0.765370138
Yes,Pennsylvania,42,"Fayette County",42051,1112,289,1401,0.7937187723
Yes,Pennsylvania,42,"Forest County",42053,85,13,98,0.8673469388
Yes,Pennsylvania,42,"Franklin County",42055,1184,266,1450,0.8165517241
Yes,Pennsylvania,42,"Fulton County",42057,173,35,208,0.8317307692
Yes,Pennsylvania,42,"Greene County",42059,302,72,374,0.807486631
Yes,Pennsylvania,42,"Huntingdon County",42061,468,109,577,0.8110918544
Yes,Pennsylvania,42,"Indiana County",42063,382,120,502,0.7609561753
Yes,Pennsylvania,42,"Jefferson County",42065,466,99,565,0.8247787611
Yes,Pennsylvania,42,"Juniata County",42067,210,44,254,0.8267716535
Yes,Pennsylvania,42,"Lackawanna County",42069,1999,492,2491,0.8024889603
Yes,Pennsylvania,42,"Lancaster County",42071,2219,610,2829,0.7843761046
Yes,Pennsylvania,42,"Lawrence County",42073,487,147,634,0.7681388013
Yes,Pennsylvania,42,"Lebanon County",42075,671,210,881,0.7616345062
Yes,Pennsylvania,42,"Lehigh County",42077,2626,611,3237,0.8112449799
Yes,Pennsylvania,42,"Luzerne County",42079,3402,879,4281,0.7946741416
Yes,Pennsylvania,42,"Lycoming County",42081,1046,291,1337,0.7823485415
Yes,Pennsylvania,42,"Mc Kean County",42083,510,112,622,0.8199356913
Yes,Pennsylvania,42,"Mercer County",42085,886,224,1110,0.7981981982
Yes,Pennsylvania,42,"Mifflin County",42087,534,147,681,0.7841409692
Yes,Pennsylvania,42,"Monroe County",42089,1166,322,1488,0.7836021505
Yes,Pennsylvania,42,"Montgomery County",42091,3153,794,3947,0.7988345579
Yes,Pennsylvania,42,"Montour County",42093,148,21,169,0.875739645
Yes,Pennsylvania,42,"Northampton County",42095,1836,475,2311,0.7944612722
Yes,Pennsylvania,42,"Northumberland County",42097,1123,242,1365,0.8227106227
Yes,Pennsylvania,42,"Perry County",42099,213,76,289,0.7370242215
Yes,Pennsylvania,42,"Philadelphia County",42101,13943,4727,18670,0.7468130691
Yes,Pennsylvania,42,"Pike County",42103,375,122,497,0.754527163
Yes,Pennsylvania,42,"Potter County",42105,209,45,254,0.8228346457
Yes,Pennsylvania,42,"Schuylkill County",42107,1576,395,1971,0.7995941147
Yes,Pennsylvania,42,"Snyder County",42109,275,73,348,0.7902298851
Yes,Pennsylvania,42,"Somerset County",42111,547,143,690,0.7927536232
Yes,Pennsylvania,42,"Sullivan County",42113,73,22,95,0.7684210526
Yes,Pennsylvania,42,"Susquehanna County",42115,378,79,457,0.8271334792
Yes,Pennsylvania,42,"Tioga County",42117,424,98,522,0.8122605364
Yes,Pennsylvania,42,"Union County",42119,266,57,323,0.8235294118
Yes,Pennsylvania,42,"Venango County",42121,575,132,707,0.8132956153
Yes,Pennsylvania,42,"Warren County",42123,407,96,503,0.8091451292
Yes,Pennsylvania,42,"Washington County",42125,901,232,1133,0.7952338923
Yes,Pennsylvania,42,"Wayne County",42127,509,118,627,0.8118022329
Yes,Pennsylvania,42,"Westmoreland County",42129,1538,406,1944,0.7911522634
Yes,Pennsylvania,42,"Wyoming County",42131,229,64,293,0.7815699659
Yes,Pennsylvania,42,"York County",42133,2143,564,2707,0.7916512745
Yes,Pennsylvania,42,,42999,57,19,76,0.75
Yes,"Rhode Island",44,"Bristol County",44001,231,48,279,0.8279569892
Yes,"Rhode Island",44,"Kent County",44003,1063,209,1272,0.8356918239
Yes,"Rhode Island",44,"Newport County",44005,454,80,534,0.8501872659
Yes,"Rhode Island",44,"Providence County",44007,5271,1295,6566,0.802771855
Yes,"Rhode Island",44,"Washington County",44009,528,132,660,0.8
Yes,"Rhode Island",44,,44999,.,0,.,1
Yes,"South Carolina",45,"Abbeville County",45001,276,82,358,0.7709497207
Yes,"South Carolina",45,"Aiken County",45003,1078,403,1481,0.7278865631
Yes,"South Carolina",45,"Allendale County",45005,136,62,198,0.6868686869
Yes,"South Carolina",45,"Anderson County",45007,1307,504,1811,0.7217007178
Yes,"South Carolina",45,"Bamberg County",45009,201,88,289,0.6955017301
Yes,"South Carolina",45,"Barnwell County",45011,260,106,366,0.7103825137
Yes,"South Carolina",45,"Beaufort County",45013,487,212,699,0.6967095851
Yes,"South Carolina",45,"Berkeley County",45015,816,341,1157,0.7052722558
Yes,"South Carolina",45,"Calhoun County",45017,130,48,178,0.7303370787
Yes,"South Carolina",45,"Charleston County",45019,1539,651,2190,0.702739726
Yes,"South Carolina",45,"Cherokee County",45021,530,176,706,0.7507082153
Yes,"South Carolina",45,"Chester County",45023,393,156,549,0.7158469945
Yes,"South Carolina",45,"Chesterfield County",45025,594,194,788,0.7538071066
Yes,"South Carolina",45,"Clarendon County",45027,453,167,620,0.7306451613
Yes,"South Carolina",45,"Colleton County",45029,433,199,632,0.6851265823
Yes,"South Carolina",45,"Darlington County",45031,850,346,1196,0.7107023411
Yes,"South Carolina",45,"Dillon County",45033,525,214,739,0.7104194858
Yes,"South Carolina",45,"Dorchester County",45035,661,267,928,0.7122844828
Yes,"South Carolina",45,"Edgefield County",45037,221,74,295,0.7491525424
Yes,"South Carolina",45,"Fairfield County",45039,227,103,330,0.6878787879
Yes,"South Carolina",45,"Florence County",45041,1617,739,2356,0.6863327674
Yes,"South Carolina",45,"Georgetown County",45043,551,208,759,0.7259552042
Yes,"South Carolina",45,"Greenville County",45045,2391,914,3305,0.7234493192
Yes,"South Carolina",45,"Greenwood County",45047,567,213,780,0.7269230769
Yes,"South Carolina",45,"Hampton County",45049,219,113,332,0.6596385542
Yes,"South Carolina",45,"Horry County",45051,2404,791,3195,0.7524256651
Yes,"South Carolina",45,"Jasper County",45053,177,75,252,0.7023809524
Yes,"South Carolina",45,"Kershaw County",45055,527,213,740,0.7121621622
Yes,"South Carolina",45,"Lancaster County",45057,752,269,1021,0.736532811
Yes,"South Carolina",45,"Laurens County",45059,743,271,1014,0.7327416174
Yes,"South Carolina",45,"Lee County",45061,295,141,436,0.6766055046
Yes,"South Carolina",45,"Lexington County",45063,1303,430,1733,0.7518753606
Yes,"South Carolina",45,"McCormick County",45065,119,54,173,0.6878612717
Yes,"South Carolina",45,"Marion County",45067,567,297,864,0.65625
Yes,"South Carolina",45,"Marlboro County",45069,484,209,693,0.6984126984
Yes,"South Carolina",45,"Newberry County",45071,318,116,434,0.732718894
Yes,"South Carolina",45,"Oconee County",45073,684,236,920,0.7434782609
Yes,"South Carolina",45,"Orangeburg County",45075,873,332,1205,0.7244813278
Yes,"South Carolina",45,"Pickens County",45077,749,211,960,0.7802083333
Yes,"South Carolina",45,"Richland County",45079,1862,768,2630,0.7079847909
Yes,"South Carolina",45,"Saluda County",45081,224,63,287,0.7804878049
Yes,"South Carolina",45,"Spartanburg County",45083,2041,743,2784,0.7331178161
Yes,"South Carolina",45,"Sumter County",45085,1062,480,1542,0.6887159533
Yes,"South Carolina",45,"Union County",45087,357,125,482,0.7406639004
Yes,"South Carolina",45,"Williamsburg County",45089,570,219,789,0.7224334601
Yes,"South Carolina",45,"York County",45091,1280,417,1697,0.7542722451
Yes,"South Carolina",45,,45999,.,.,.,0.5833333333
Yes,"South Dakota",46,"Aurora County",46003,.,.,.,0.8
Yes,"South Dakota",46,"Beadle County",46005,138,36,174,0.7931034483
Yes,"South Dakota",46,"Bennett County",46007,.,.,.,0.75
Yes,"South Dakota",46,"Bon Homme County",46009,.,.,.,0.775
Yes,"South Dakota",46,"Brookings County",46011,115,18,133,0.8646616541
Yes,"South Dakota",46,"Brown County",46013,261,60,321,0.8130841121
Yes,"South Dakota",46,"Brule County",46015,.,.,.,0.8771929825
Yes,"South Dakota",46,"Buffalo County",46017,.,.,.,0.1818181818
Yes,"South Dakota",46,"Butte County",46019,85,21,106,0.8018867925
Yes,"South Dakota",46,"Campbell County",46021,.,.,.,0.8333333333
Yes,"South Dakota",46,"Charles Mix County",46023,72,27,99,0.7272727273
Yes,"South Dakota",46,"Clark County",46025,.,.,.,0.880952381
Yes,"South Dakota",46,"Clay County",46027,73,13,86,0.8488372093
Yes,"South Dakota",46,"Codington County",46029,173,36,209,0.8277511962
Yes,"South Dakota",46,"Corson County",46031,14,29,43,0.3255813953
Yes,"South Dakota",46,"Custer County",46033,43,15,58,0.7413793103
Yes,"South Dakota",46,"Davison County",46035,170,37,207,0.8212560386
Yes,"South Dakota",46,"Day County",46037,.,.,.,0.9054054054
Yes,"South Dakota",46,"Deuel County",46039,.,.,.,0.7058823529
Yes,"South Dakota",46,"Dewey County",46041,28,19,47,0.5957446809
Yes,"South Dakota",46,"Douglas County",46043,.,.,.,0.8214285714
Yes,"South Dakota",46,"Edmunds County",46045,.,.,.,0.8108108108
Yes,"South Dakota",46,"Fall River County",46047,75,14,89,0.8426966292
Yes,"South Dakota",46,"Faulk County",46049,.,.,.,0.8611111111
Yes,"South Dakota",46,"Grant County",46051,55,15,70,0.7857142857
Yes,"South Dakota",46,"Gregory County",46053,.,.,.,0.847826087
Yes,"South Dakota",46,"Haakon County",46055,.,.,.,0.85
Yes,"South Dakota",46,"Hamlin County",46057,.,.,.,0.8536585366
Yes,"South Dakota",46,"Hand County",46059,.,.,.,0.8387096774
Yes,"South Dakota",46,"Hanson County",46061,38,11,49,0.7755102041
Yes,"South Dakota",46,"Harding County",46063,.,0,.,1
Yes,"South Dakota",46,"Hughes County",46065,96,26,122,0.7868852459
Yes,"South Dakota",46,"Hutchinson County",46067,.,.,.,0.8507462687
Yes,"South Dakota",46,"Hyde County",46069,.,.,.,0.75
Yes,"South Dakota",46,"Jackson County",46071,15,15,30,0.5
Yes,"South Dakota",46,"Jerauld County",46073,.,.,.,0.7727272727
Yes,"South Dakota",46,"Jones County",46075,.,.,.,0.6
Yes,"South Dakota",46,"Kingsbury County",46077,.,.,.,0.8125
Yes,"South Dakota",46,"Lake County",46079,56,12,68,0.8235294118
Yes,"South Dakota",46,"Lawrence County",46081,139,18,157,0.8853503185
Yes,"South Dakota",46,"Lincoln County",46083,127,20,147,0.8639455782
Yes,"South Dakota",46,"Lyman County",46085,.,.,.,0.7916666667
Yes,"South Dakota",46,"McCook County",46087,.,.,.,0.7954545455
Yes,"South Dakota",46,"McPherson County",46089,.,.,.,0.9411764706
Yes,"South Dakota",46,"Marshall County",46091,.,.,.,0.8
Yes,"South Dakota",46,"Meade County",46093,123,27,150,0.82
Yes,"South Dakota",46,"Mellette County",46095,.,.,.,0.75
Yes,"South Dakota",46,"Miner County",46097,.,.,.,0.7037037037
Yes,"South Dakota",46,"Minnehaha County",46099,939,216,1155,0.812987013
Yes,"South Dakota",46,"Moody County",46101,.,.,.,0.8684210526
Yes,"South Dakota",46,,46102,26,81,107,0.2429906542
Yes,"South Dakota",46,"Pennington County",46103,485,182,667,0.7271364318
Yes,"South Dakota",46,"Perkins County",46105,.,.,.,0.75
Yes,"South Dakota",46,"Potter County",46107,.,.,.,0.6875
Yes,"South Dakota",46,"Roberts County",46109,62,19,81,0.7654320988
Yes,"South Dakota",46,"Sanborn County",46111,.,.,.,0.7
Yes,"South Dakota",46,"Spink County",46115,74,13,87,0.8505747126
Yes,"South Dakota",46,"Stanley County",46117,.,.,.,0.75
Yes,"South Dakota",46,"Sully County",46119,.,0,.,1
Yes,"South Dakota",46,"Todd County",46121,33,47,80,0.4125
Yes,"South Dakota",46,"Tripp County",46123,58,16,74,0.7837837838
Yes,"South Dakota",46,"Turner County",46125,61,14,75,0.8133333333
Yes,"South Dakota",46,"Union County",46127,85,12,97,0.8762886598
Yes,"South Dakota",46,"Walworth County",46129,59,11,70,0.8428571429
Yes,"South Dakota",46,"Yankton County",46135,171,30,201,0.8507462687
Yes,"South Dakota",46,"Ziebach County",46137,.,.,.,0.2
Yes,"South Dakota",46,,46999,.,0,.,1
Yes,Tennessee,47,"Anderson County",47001,562,171,733,0.7667121419
Yes,Tennessee,47,"Bedford County",47003,321,114,435,0.7379310345
Yes,Tennessee,47,"Benton County",47005,222,72,294,0.7551020408
Yes,Tennessee,47,"Bledsoe County",47007,197,52,249,0.7911646586
Yes,Tennessee,47,"Blount County",47009,674,231,905,0.7447513812
Yes,Tennessee,47,"Bradley County",47011,808,228,1036,0.7799227799
Yes,Tennessee,47,"Campbell County",47013,536,210,746,0.7184986595
Yes,Tennessee,47,"Cannon County",47015,96,53,149,0.644295302
Yes,Tennessee,47,"Carroll County",47017,388,150,538,0.7211895911
Yes,Tennessee,47,"Carter County",47019,605,211,816,0.7414215686
Yes,Tennessee,47,"Cheatham County",47021,168,60,228,0.7368421053
Yes,Tennessee,47,"Chester County",47023,209,64,273,0.7655677656
Yes,Tennessee,47,"Claiborne County",47025,528,184,712,0.7415730337
Yes,Tennessee,47,"Clay County",47027,171,55,226,0.7566371681
Yes,Tennessee,47,"Cocke County",47029,551,191,742,0.7425876011
Yes,Tennessee,47,"Coffee County",47031,497,176,673,0.7384843982
Yes,Tennessee,47,"Crockett County",47033,176,85,261,0.6743295019
Yes,Tennessee,47,"Cumberland County",47035,830,242,1072,0.7742537313
Yes,Tennessee,47,"Davidson County",47037,2198,912,3110,0.7067524116
Yes,Tennessee,47,"Decatur County",47039,179,62,241,0.7427385892
Yes,Tennessee,47,"DeKalb County",47041,198,61,259,0.7644787645
Yes,Tennessee,47,"Dickson County",47043,319,120,439,0.7266514806
Yes,Tennessee,47,"Dyer County",47045,547,195,742,0.7371967655
Yes,Tennessee,47,"Fayette County",47047,284,120,404,0.702970297
Yes,Tennessee,47,"Fentress County",47049,517,130,647,0.799072643
Yes,Tennessee,47,"Franklin County",47051,397,125,522,0.7605363985
Yes,Tennessee,47,"Gibson County",47053,684,256,940,0.7276595745
Yes,Tennessee,47,"Giles County",47055,292,108,400,0.73
Yes,Tennessee,47,"Grainger County",47057,275,84,359,0.7660167131
Yes,Tennessee,47,"Greene County",47059,768,230,998,0.7695390782
Yes,Tennessee,47,"Grundy County",47061,316,74,390,0.8102564103
Yes,Tennessee,47,"Hamblen County",47063,595,195,790,0.753164557
Yes,Tennessee,47,"Hamilton County",47065,2039,716,2755,0.7401088929
Yes,Tennessee,47,"Hancock County",47067,148,42,190,0.7789473684
Yes,Tennessee,47,"Hardeman County",47069,359,158,517,0.6943907157
Yes,Tennessee,47,"Hardin County",47071,464,132,596,0.7785234899
Yes,Tennessee,47,"Hawkins County",47073,599,153,752,0.7965425532
Yes,Tennessee,47,"Haywood County",47075,269,117,386,0.6968911917
Yes,Tennessee,47,"Henderson County",47077,380,137,517,0.7350096712
Yes,Tennessee,47,"Henry County",47079,434,115,549,0.7905282332
Yes,Tennessee,47,"Hickman County",47081,171,62,233,0.7339055794
Yes,Tennessee,47,"Houston County",47083,80,39,119,0.6722689076
Yes,Tennessee,47,"Humphreys County",47085,158,63,221,0.7149321267
Yes,Tennessee,47,"Jackson County",47087,205,72,277,0.7400722022
Yes,Tennessee,47,"Jefferson County",47089,473,169,642,0.7367601246
Yes,Tennessee,47,"Johnson County",47091,261,91,352,0.7414772727
Yes,Tennessee,47,"Knox County",47093,2099,787,2886,0.7273042273
Yes,Tennessee,47,"Lake County",47095,131,57,188,0.6968085106
Yes,Tennessee,47,"Lauderdale County",47097,313,158,471,0.6645435244
Yes,Tennessee,47,"Lawrence County",47099,484,155,639,0.7574334898
Yes,Tennessee,47,"Lewis County",47101,141,36,177,0.7966101695
Yes,Tennessee,47,"Lincoln County",47103,375,101,476,0.7878151261
Yes,Tennessee,47,"Loudon County",47105,258,94,352,0.7329545455
Yes,Tennessee,47,"McMinn County",47107,570,153,723,0.7883817427
Yes,Tennessee,47,"McNairy County",47109,423,148,571,0.7408056042
Yes,Tennessee,47,"Macon County",47111,268,116,384,0.6979166667
Yes,Tennessee,47,"Madison County",47113,914,432,1346,0.6790490342
Yes,Tennessee,47,"Marion County",47115,281,132,413,0.6803874092
Yes,Tennessee,47,"Marshall County",47117,230,87,317,0.7255520505
Yes,Tennessee,47,"Maury County",47119,475,181,656,0.7240853659
Yes,Tennessee,47,"Meigs County",47121,162,51,213,0.7605633803
Yes,Tennessee,47,"Monroe County",47123,514,152,666,0.7717717718
Yes,Tennessee,47,"Montgomery County",47125,798,304,1102,0.724137931
Yes,Tennessee,47,"Moore County",47127,44,24,68,0.6470588235
Yes,Tennessee,47,"Morgan County",47129,226,65,291,0.7766323024
Yes,Tennessee,47,"Obion County",47131,389,152,541,0.719038817
Yes,Tennessee,47,"Overton County",47133,381,110,491,0.7759674134
Yes,Tennessee,47,"Perry County",47135,102,31,133,0.7669172932
Yes,Tennessee,47,"Pickett County",47137,131,33,164,0.7987804878
Yes,Tennessee,47,"Polk County",47139,251,80,331,0.7583081571
Yes,Tennessee,47,"Putnam County",47141,758,257,1015,0.7467980296
Yes,Tennessee,47,"Rhea County",47143,335,122,457,0.7330415755
Yes,Tennessee,47,"Roane County",47145,474,167,641,0.7394695788
Yes,Tennessee,47,"Robertson County",47147,408,126,534,0.7640449438
Yes,Tennessee,47,"Rutherford County",47149,978,360,1338,0.730941704
Yes,Tennessee,47,"Scott County",47151,450,144,594,0.7575757576
Yes,Tennessee,47,"Sequatchie County",47153,229,61,290,0.7896551724
Yes,Tennessee,47,"Sevier County",47155,700,187,887,0.7891770011
Yes,Tennessee,47,"Shelby County",47157,5300,2608,7908,0.6702073849
Yes,Tennessee,47,"Smith County",47159,184,64,248,0.7419354839
Yes,Tennessee,47,"Stewart County",47161,142,51,193,0.7357512953
Yes,Tennessee,47,"Sullivan County",47163,1288,331,1619,0.7955528104
Yes,Tennessee,47,"Sumner County",47165,810,335,1145,0.7074235808
Yes,Tennessee,47,"Tipton County",47167,441,181,622,0.7090032154
Yes,Tennessee,47,"Trousdale County",47169,120,38,158,0.7594936709
Yes,Tennessee,47,"Unicoi County",47171,214,70,284,0.7535211268
Yes,Tennessee,47,"Union County",47173,184,84,268,0.6865671642
Yes,Tennessee,47,"Van Buren County",47175,105,31,136,0.7720588235
Yes,Tennessee,47,"Warren County",47177,531,176,707,0.7510608204
Yes,Tennessee,47,"Washington County",47179,895,365,1260,0.7103174603
Yes,Tennessee,47,"Wayne County",47181,223,67,290,0.7689655172
Yes,Tennessee,47,"Weakley County",47183,469,135,604,0.7764900662
Yes,Tennessee,47,"White County",47185,373,138,511,0.7299412916
Yes,Tennessee,47,"Williamson County",47187,337,98,435,0.7747126437
Yes,Tennessee,47,"Wilson County",47189,574,188,762,0.7532808399
Yes,Tennessee,47,,47999,30,17,47,0.6382978723
Yes,Texas,48,"Anderson County",48001,421,166,587,0.7172061329
Yes,Texas,48,"Andrews County",48003,83,43,126,0.6587301587
Yes,Texas,48,"Angelina County",48005,731,311,1042,0.7015355086
Yes,Texas,48,"Aransas County",48007,109,56,165,0.6606060606
Yes,Texas,48,"Archer County",48009,47,16,63,0.746031746
Yes,Texas,48,"Armstrong County",48011,.,.,.,0.6875
Yes,Texas,48,"Atascosa County",48013,264,143,407,0.6486486486
Yes,Texas,48,"Austin County",48015,154,75,229,0.672489083
Yes,Texas,48,"Bailey County",48017,62,16,78,0.7948717949
Yes,Texas,48,"Bandera County",48019,112,51,163,0.6871165644
Yes,Texas,48,"Bastrop County",48021,363,187,550,0.66
Yes,Texas,48,"Baylor County",48023,45,22,67,0.671641791
Yes,Texas,48,"Bee County",48025,201,95,296,0.6790540541
Yes,Texas,48,"Bell County",48027,1472,624,2096,0.7022900763
Yes,Texas,48,"Bexar County",48029,6938,3189,10127,0.6850992397
Yes,Texas,48,"Blanco County",48031,56,21,77,0.7272727273
Yes,Texas,48,"Borden County",48033,.,.,.,0.3333333333
Yes,Texas,48,"Bosque County",48035,127,45,172,0.738372093
Yes,Texas,48,"Bowie County",48037,727,362,1089,0.6675849403
Yes,Texas,48,"Brazoria County",48039,1194,491,1685,0.7086053412
Yes,Texas,48,"Brazos County",48041,652,289,941,0.692879915
Yes,Texas,48,"Brewster County",48043,46,28,74,0.6216216216
Yes,Texas,48,"Briscoe County",48045,.,.,.,0.8333333333
Yes,Texas,48,"Brooks County",48047,115,62,177,0.6497175141
Yes,Texas,48,"Brown County",48049,359,135,494,0.7267206478
Yes,Texas,48,"Burleson County",48051,122,53,175,0.6971428571
Yes,Texas,48,"Burnet County",48053,238,75,313,0.7603833866
Yes,Texas,48,"Caldwell County",48055,304,134,438,0.6940639269
Yes,Texas,48,"Calhoun County",48057,123,58,181,0.679558011
Yes,Texas,48,"Callahan County",48059,94,42,136,0.6911764706
Yes,Texas,48,"Cameron County",48061,4022,1505,5527,0.72770038
Yes,Texas,48,"Camp County",48063,100,42,142,0.7042253521
Yes,Texas,48,"Carson County",48065,19,12,31,0.6129032258
Yes,Texas,48,"Cass County",48067,333,136,469,0.710021322
Yes,Texas,48,"Castro County",48069,46,17,63,0.7301587302
Yes,Texas,48,"Chambers County",48071,133,69,202,0.6584158416
Yes,Texas,48,"Cherokee County",48073,440,190,630,0.6984126984
Yes,Texas,48,"Childress County",48075,58,20,78,0.7435897436
Yes,Texas,48,"Clay County",48077,57,31,88,0.6477272727
Yes,Texas,48,"Cochran County",48079,26,20,46,0.5652173913
Yes,Texas,48,"Coke County",48081,22,14,36,0.6111111111
Yes,Texas,48,"Coleman County",48083,98,33,131,0.7480916031
Yes,Texas,48,"Collin County",48085,2176,800,2976,0.7311827957
Yes,Texas,48,"Collingsworth County",48087,38,14,52,0.7307692308
Yes,Texas,48,"Colorado County",48089,183,72,255,0.7176470588
Yes,Texas,48,"Comal County",48091,457,168,625,0.7312
Yes,Texas,48,"Comanche County",48093,125,51,176,0.7102272727
Yes,Texas,48,"Concho County",48095,28,17,45,0.6222222222
Yes,Texas,48,"Cooke County",48097,218,95,313,0.696485623
Yes,Texas,48,"Coryell County",48099,325,126,451,0.7206208426
Yes,Texas,48,"Cottle County",48101,.,.,.,0.8
Yes,Texas,48,"Crane County",48103,.,.,.,0.7567567568
Yes,Texas,48,"Crockett County",48105,24,13,37,0.6486486486
Yes,Texas,48,"Crosby County",48107,49,29,78,0.6282051282
Yes,Texas,48,"Culberson County",48109,31,14,45,0.6888888889
Yes,Texas,48,"Dallam County",48111,37,15,52,0.7115384615
Yes,Texas,48,"Dallas County",48113,10416,4981,15397,0.6764954212
Yes,Texas,48,"Dawson County",48115,116,35,151,0.7682119205
Yes,Texas,48,"Deaf Smith County",48117,124,61,185,0.6702702703
Yes,Texas,48,"Delta County",48119,55,21,76,0.7236842105
Yes,Texas,48,"Denton County",48121,1899,731,2630,0.7220532319
Yes,Texas,48,"DeWitt County",48123,179,81,260,0.6884615385
Yes,Texas,48,"Dickens County",48125,.,.,.,0.8461538462
Yes,Texas,48,"Dimmit County",48127,149,72,221,0.6742081448
Yes,Texas,48,"Donley County",48129,42,14,56,0.75
Yes,Texas,48,"Duval County",48131,177,61,238,0.743697479
Yes,Texas,48,"Eastland County",48133,201,71,272,0.7389705882
Yes,Texas,48,"Ector County",48135,795,370,1165,0.6824034335
Yes,Texas,48,"Edwards County",48137,.,.,.,0.9411764706
Yes,Texas,48,"Ellis County",48139,659,293,952,0.6922268908
Yes,Texas,48,"El Paso County",48141,4639,1971,6610,0.7018154312
Yes,Texas,48,"Erath County",48143,208,83,291,0.7147766323
Yes,Texas,48,"Falls County",48145,135,73,208,0.6490384615
Yes,Texas,48,"Fannin County",48147,250,141,391,0.6393861893
Yes,Texas,48,"Fayette County",48149,163,85,248,0.6572580645
Yes,Texas,48,"Fisher County",48151,.,.,.,0.7727272727
Yes,Texas,48,"Floyd County",48153,50,28,78,0.641025641
Yes,Texas,48,"Foard County",48155,.,.,.,0.68
Yes,Texas,48,"Fort Bend County",48157,2305,860,3165,0.7282780411
Yes,Texas,48,"Franklin County",48159,68,28,96,0.7083333333
Yes,Texas,48,"Freestone County",48161,148,57,205,0.7219512195
Yes,Texas,48,"Frio County",48163,172,97,269,0.6394052045
Yes,Texas,48,"Gaines County",48165,95,39,134,0.7089552239
Yes,Texas,48,"Galveston County",48167,1407,691,2098,0.6706387035
Yes,Texas,48,"Garza County",48169,27,17,44,0.6136363636
Yes,Texas,48,"Gillespie County",48171,123,34,157,0.7834394904
Yes,Texas,48,"Glasscock County",48173,.,.,.,0.5714285714
Yes,Texas,48,"Goliad County",48175,62,20,82,0.756097561
Yes,Texas,48,"Gonzales County",48177,209,95,304,0.6875
Yes,Texas,48,"Gray County",48179,135,84,219,0.6164383562
Yes,Texas,48,"Grayson County",48181,935,433,1368,0.6834795322
Yes,Texas,48,"Gregg County",48183,846,404,1250,0.6768
Yes,Texas,48,"Grimes County",48185,188,101,289,0.6505190311
Yes,Texas,48,"Guadalupe County",48187,635,262,897,0.7079152731
Yes,Texas,48,"Hale County",48189,244,111,355,0.6873239437
Yes,Texas,48,"Hall County",48191,33,20,53,0.6226415094
Yes,Texas,48,"Hamilton County",48193,87,24,111,0.7837837838
Yes,Texas,48,"Hansford County",48195,27,14,41,0.6585365854
Yes,Texas,48,"Hardeman County",48197,38,14,52,0.7307692308
Yes,Texas,48,"Hardin County",48199,284,120,404,0.702970297
Yes,Texas,48,"Harris County",48201,14392,6566,20958,0.6867067468
Yes,Texas,48,"Harrison County",48203,494,231,725,0.6813793103
Yes,Texas,48,"Hartley County",48205,.,.,.,0.8636363636
Yes,Texas,48,"Haskell County",48207,78,26,104,0.75
Yes,Texas,48,"Hays County",48209,506,188,694,0.7291066282
Yes,Texas,48,"Hemphill County",48211,.,.,.,0.8333333333
Yes,Texas,48,"Henderson County",48213,700,299,999,0.7007007007
Yes,Texas,48,"Hidalgo County",48215,8936,2992,11928,0.7491616365
Yes,Texas,48,"Hill County",48217,320,132,452,0.7079646018
Yes,Texas,48,"Hockley County",48219,142,56,198,0.7171717172
Yes,Texas,48,"Hood County",48221,296,120,416,0.7115384615
Yes,Texas,48,"Hopkins County",48223,354,133,487,0.726899384
Yes,Texas,48,"Houston County",48225,235,109,344,0.6831395349
Yes,Texas,48,"Howard County",48227,175,83,258,0.6782945736
Yes,Texas,48,"Hudspeth County",48229,42,19,61,0.6885245902
Yes,Texas,48,"Hunt County",48231,630,291,921,0.6840390879
Yes,Texas,48,"Hutchinson County",48233,115,46,161,0.7142857143
Yes,Texas,48,"Irion County",48235,.,.,.,0.7692307692
Yes,Texas,48,"Jack County",48237,54,29,83,0.6506024096
Yes,Texas,48,"Jackson County",48239,101,50,151,0.6688741722
Yes,Texas,48,"Jasper County",48241,341,155,496,0.6875
Yes,Texas,48,"Jeff Davis County",48243,.,.,.,0.6666666667
Yes,Texas,48,"Jefferson County",48245,1399,703,2102,0.6655566127
Yes,Texas,48,"Jim Hogg County",48247,71,31,102,0.6960784314
Yes,Texas,48,"Jim Wells County",48249,426,162,588,0.7244897959
Yes,Texas,48,"Johnson County",48251,716,323,1039,0.6891241578
Yes,Texas,48,"Jones County",48253,162,62,224,0.7232142857
Yes,Texas,48,"Karnes County",48255,145,73,218,0.6651376147
Yes,Texas,48,"Kaufman County",48257,616,252,868,0.7096774194
Yes,Texas,48,"Kendall County",48259,113,58,171,0.6608187135
Yes,Texas,48,"Kenedy County",48261,.,0,.,1
Yes,Texas,48,"Kent County",48263,.,.,.,0.8181818182
Yes,Texas,48,"Kerr County",48265,308,118,426,0.7230046948
Yes,Texas,48,"Kimble County",48267,38,19,57,0.6666666667
Yes,Texas,48,"King County",48269,.,0,.,1
Yes,Texas,48,"Kinney County",48271,36,11,47,0.7659574468
Yes,Texas,48,"Kleberg County",48273,138,63,201,0.6865671642
Yes,Texas,48,"Knox County",48275,46,21,67,0.6865671642
Yes,Texas,48,"Lamar County",48277,552,259,811,0.6806411837
Yes,Texas,48,"Lamb County",48279,138,53,191,0.722513089
Yes,Texas,48,"Lampasas County",48281,134,44,178,0.7528089888
Yes,Texas,48,"La Salle County",48283,73,44,117,0.6239316239
Yes,Texas,48,"Lavaca County",48285,161,94,255,0.631372549
Yes,Texas,48,"Lee County",48287,83,35,118,0.7033898305
Yes,Texas,48,"Leon County",48289,133,58,191,0.6963350785
Yes,Texas,48,"Liberty County",48291,471,240,711,0.6624472574
Yes,Texas,48,"Limestone County",48293,207,104,311,0.6655948553
Yes,Texas,48,"Lipscomb County",48295,.,.,.,0.9333333333
Yes,Texas,48,"Live Oak County",48297,68,32,100,0.68
Yes,Texas,48,"Llano County",48299,152,67,219,0.6940639269
Yes,Texas,48,"Lubbock County",48303,1402,623,2025,0.692345679
Yes,Texas,48,"Lynn County",48305,43,24,67,0.6417910448
Yes,Texas,48,"McCulloch County",48307,107,53,160,0.66875
Yes,Texas,48,"McLennan County",48309,1440,702,2142,0.6722689076
Yes,Texas,48,"McMullen County",48311,.,.,.,0.5555555556
Yes,Texas,48,"Madison County",48313,78,46,124,0.6290322581
Yes,Texas,48,"Marion County",48315,148,69,217,0.6820276498
Yes,Texas,48,"Martin County",48317,25,14,39,0.641025641
Yes,Texas,48,"Mason County",48319,43,11,54,0.7962962963
Yes,Texas,48,"Matagorda County",48321,291,155,446,0.6524663677
Yes,Texas,48,"Maverick County",48323,1003,382,1385,0.7241877256
Yes,Texas,48,"Medina County",48325,263,130,393,0.6692111959
Yes,Texas,48,"Menard County",48327,32,15,47,0.6808510638
Yes,Texas,48,"Midland County",48329,516,247,763,0.6762778506
Yes,Texas,48,"Milam County",48331,234,94,328,0.7134146341
Yes,Texas,48,"Mills County",48333,39,17,56,0.6964285714
Yes,Texas,48,"Mitchell County",48335,59,14,73,0.8082191781
Yes,Texas,48,"Montague County",48337,171,64,235,0.7276595745
Yes,Texas,48,"Montgomery County",48339,1459,698,2157,0.6764024108
Yes,Texas,48,"Moore County",48341,102,26,128,0.796875
Yes,Texas,48,"Morris County",48343,138,72,210,0.6571428571
Yes,Texas,48,"Motley County",48345,.,.,.,0.8695652174
Yes,Texas,48,"Nacogdoches County",48347,436,216,652,0.6687116564
Yes,Texas,48,"Navarro County",48349,463,188,651,0.7112135177
Yes,Texas,48,"Newton County",48351,134,94,228,0.5877192982
Yes,Texas,48,"Nolan County",48353,146,64,210,0.6952380952
Yes,Texas,48,"Nueces County",48355,1199,600,1799,0.6664813785
Yes,Texas,48,"Ochiltree County",48357,45,11,56,0.8035714286
Yes,Texas,48,"Oldham County",48359,.,.,.,0.8235294118
Yes,Texas,48,"Orange County",48361,389,196,585,0.664957265
Yes,Texas,48,"Palo Pinto County",48363,228,96,324,0.7037037037
Yes,Texas,48,"Panola County",48365,182,88,270,0.6740740741
Yes,Texas,48,"Parker County",48367,580,221,801,0.7240948814
Yes,Texas,48,"Parmer County",48369,84,18,102,0.8235294118
Yes,Texas,48,"Pecos County",48371,96,52,148,0.6486486486
Yes,Texas,48,"Polk County",48373,406,220,626,0.6485623003
Yes,Texas,48,"Potter County",48375,763,363,1126,0.6776198934
Yes,Texas,48,"Presidio County",48377,116,51,167,0.6946107784
Yes,Texas,48,"Rains County",48379,97,35,132,0.7348484848
Yes,Texas,48,"Randall County",48381,439,234,673,0.6523031204
Yes,Texas,48,"Reagan County",48383,.,.,.,0.8529411765
Yes,Texas,48,"Real County",48385,47,15,62,0.7580645161
Yes,Texas,48,"Red River County",48387,265,76,341,0.7771260997
Yes,Texas,48,"Reeves County",48389,130,61,191,0.6806282723
Yes,Texas,48,"Refugio County",48391,64,32,96,0.6666666667
Yes,Texas,48,"Roberts County",48393,.,0,.,1
Yes,Texas,48,"Robertson County",48395,156,60,216,0.7222222222
Yes,Texas,48,"Rockwall County",48397,204,118,322,0.6335403727
Yes,Texas,48,"Runnels County",48399,120,41,161,0.7453416149
Yes,Texas,48,"Rusk County",48401,373,157,530,0.7037735849
Yes,Texas,48,"Sabine County",48403,110,53,163,0.6748466258
Yes,Texas,48,"San Augustine County",48405,130,53,183,0.7103825137
Yes,Texas,48,"San Jacinto County",48407,205,101,306,0.6699346405
Yes,Texas,48,"San Patricio County",48409,338,119,457,0.7396061269
Yes,Texas,48,"San Saba County",48411,53,24,77,0.6883116883
Yes,Texas,48,"Schleicher County",48413,28,14,42,0.6666666667
Yes,Texas,48,"Scurry County",48415,114,56,170,0.6705882353
Yes,Texas,48,"Shackelford County",48417,.,.,.,0.8571428571
Yes,Texas,48,"Shelby County",48419,215,113,328,0.6554878049
Yes,Texas,48,"Sherman County",48421,.,.,.,0.75
Yes,Texas,48,"Smith County",48423,1300,649,1949,0.6670087224
Yes,Texas,48,"Somervell County",48425,34,20,54,0.6296296296
Yes,Texas,48,"Starr County",48427,1474,457,1931,0.7633350596
Yes,Texas,48,"Stephens County",48429,69,23,92,0.75
Yes,Texas,48,"Sterling County",48431,.,.,.,0.4
Yes,Texas,48,"Stonewall County",48433,.,.,.,0.8181818182
Yes,Texas,48,"Sutton County",48435,32,14,46,0.6956521739
Yes,Texas,48,"Swisher County",48437,66,30,96,0.6875
Yes,Texas,48,"Tarrant County",48439,6924,3236,10160,0.681496063
Yes,Texas,48,"Taylor County",48441,906,409,1315,0.688973384
Yes,Texas,48,"Terrell County",48443,.,.,.,0.8461538462
Yes,Texas,48,"Terry County",48445,87,48,135,0.6444444444
Yes,Texas,48,"Throckmorton County",48447,.,.,.,0.7272727273
Yes,Texas,48,"Titus County",48449,232,103,335,0.6925373134
Yes,Texas,48,"Tom Green County",48451,747,334,1081,0.691026827
Yes,Texas,48,"Travis County",48453,2785,1182,3967,0.7020418452
Yes,Texas,48,"Trinity County",48455,169,89,258,0.6550387597
Yes,Texas,48,"Tyler County",48457,195,100,295,0.6610169492
Yes,Texas,48,"Upshur County",48459,333,136,469,0.710021322
Yes,Texas,48,"Upton County",48461,25,11,36,0.6944444444
Yes,Texas,48,"Uvalde County",48463,304,121,425,0.7152941176
Yes,Texas,48,"Val Verde County",48465,593,238,831,0.7135980746
Yes,Texas,48,"Van Zandt County",48467,419,192,611,0.6857610475
Yes,Texas,48,"Victoria County",48469,620,275,895,0.6927374302
Yes,Texas,48,"Walker County",48471,285,155,440,0.6477272727
Yes,Texas,48,"Waller County",48473,176,83,259,0.6795366795
Yes,Texas,48,"Ward County",48475,79,40,119,0.6638655462
Yes,Texas,48,"Washington County",48477,218,104,322,0.6770186335
Yes,Texas,48,"Webb County",48479,2081,877,2958,0.7035158891
Yes,Texas,48,"Wharton County",48481,317,164,481,0.659043659
Yes,Texas,48,"Wheeler County",48483,40,12,52,0.7692307692
Yes,Texas,48,"Wichita County",48485,981,359,1340,0.7320895522
Yes,Texas,48,"Wilbarger County",48487,114,69,183,0.6229508197
Yes,Texas,48,"Willacy County",48489,252,127,379,0.6649076517
Yes,Texas,48,"Williamson County",48491,1293,509,1802,0.717536071
Yes,Texas,48,"Wilson County",48493,173,96,269,0.6431226766
Yes,Texas,48,"Winkler County",48495,38,25,63,0.6031746032
Yes,Texas,48,"Wise County",48497,328,151,479,0.6847599165
Yes,Texas,48,"Wood County",48499,391,170,561,0.696969697
Yes,Texas,48,"Yoakum County",48501,49,21,70,0.7
Yes,Texas,48,"Young County",48503,161,72,233,0.6909871245
Yes,Texas,48,"Zapata County",48505,171,45,216,0.7916666667
Yes,Texas,48,"Zavala County",48507,156,69,225,0.6933333333
Yes,Texas,48,,48999,150,87,237,0.6329113924
Yes,Utah,49,"Beaver County",49001,.,.,.,0.9189189189
Yes,Utah,49,"Box Elder County",49003,113,43,156,0.7243589744
Yes,Utah,49,"Cache County",49005,162,71,233,0.69527897
Yes,Utah,49,"Carbon County",49007,115,52,167,0.6886227545
Yes,Utah,49,"Daggett County",49009,.,.,.,0.5
Yes,Utah,49,"Davis County",49011,301,112,413,0.7288135593
Yes,Utah,49,"Duchesne County",49013,65,28,93,0.6989247312
Yes,Utah,49,"Emery County",49015,33,12,45,0.7333333333
Yes,Utah,49,"Garfield County",49017,.,.,.,0.8461538462
Yes,Utah,49,"Grand County",49019,37,15,52,0.7115384615
Yes,Utah,49,"Iron County",49021,162,52,214,0.7570093458
Yes,Utah,49,"Juab County",49023,.,.,.,0.7906976744
Yes,Utah,49,"Kane County",49025,.,.,.,0.8163265306
Yes,Utah,49,"Millard County",49027,43,16,59,0.7288135593
Yes,Utah,49,"Morgan County",49029,.,.,.,0.6666666667
Yes,Utah,49,"Piute County",49031,.,.,.,0.6363636364
Yes,Utah,49,"Rich County",49033,.,.,.,0.5
Yes,Utah,49,"Salt Lake County",49035,1550,716,2266,0.6840247132
Yes,Utah,49,"San Juan County",49037,63,39,102,0.6176470588
Yes,Utah,49,"Sanpete County",49039,87,31,118,0.7372881356
Yes,Utah,49,"Sevier County",49041,104,26,130,0.8
Yes,Utah,49,"Summit County",49043,.,.,.,0.7307692308
Yes,Utah,49,"Tooele County",49045,105,49,154,0.6818181818
Yes,Utah,49,"Uintah County",49047,88,36,124,0.7096774194
Yes,Utah,49,"Utah County",49049,564,242,806,0.699751861
Yes,Utah,49,"Wasatch County",49051,24,13,37,0.6486486486
Yes,Utah,49,"Washington County",49053,399,154,553,0.7215189873
Yes,Utah,49,"Wayne County",49055,.,.,.,0.6
Yes,Utah,49,"Weber County",49057,468,187,655,0.7145038168
Yes,Utah,49,,49999,.,.,.,0.8571428571
Yes,Vermont,50,"Addison County",50001,283,68,351,0.8062678063
Yes,Vermont,50,"Bennington County",50003,419,100,519,0.8073217726
Yes,Vermont,50,"Caledonia County",50005,348,86,434,0.801843318
Yes,Vermont,50,"Chittenden County",50007,827,200,1027,0.8052580331
Yes,Vermont,50,"Essex County",50009,117,15,132,0.8863636364
Yes,Vermont,50,"Franklin County",50011,534,96,630,0.8476190476
Yes,Vermont,50,"Grand Isle County",50013,52,16,68,0.7647058824
Yes,Vermont,50,"Lamoille County",50015,215,46,261,0.8237547893
Yes,Vermont,50,"Orange County",50017,351,75,426,0.823943662
Yes,Vermont,50,"Orleans County",50019,564,123,687,0.8209606987
Yes,Vermont,50,"Rutland County",50021,805,178,983,0.8189216684
Yes,Vermont,50,"Washington County",50023,575,105,680,0.8455882353
Yes,Vermont,50,"Windham County",50025,520,121,641,0.8112324493
Yes,Vermont,50,"Windsor County",50027,618,162,780,0.7923076923
Yes,Vermont,50,,50999,.,0,.,1
Yes,Virginia,51,"Accomack County",51001,429,164,593,0.7234401349
Yes,Virginia,51,"Albemarle County",51003,345,107,452,0.7632743363
Yes,Virginia,51,"Alleghany County",51005,195,64,259,0.7528957529
Yes,Virginia,51,"Amelia County",51007,104,26,130,0.8
Yes,Virginia,51,"Amherst County",51009,315,90,405,0.7777777778
Yes,Virginia,51,"Appomattox County",51011,162,54,216,0.75
Yes,Virginia,51,"Arlington County",51013,525,183,708,0.7415254237
Yes,Virginia,51,"Augusta County",51015,490,114,604,0.8112582781
Yes,Virginia,51,"Bath County",51017,56,16,72,0.7777777778
Yes,Virginia,51,"Bedford County",51019,472,150,622,0.7588424437
Yes,Virginia,51,"Bland County",51021,54,24,78,0.6923076923
Yes,Virginia,51,"Botetourt County",51023,160,49,209,0.7655502392
Yes,Virginia,51,"Brunswick County",51025,281,88,369,0.7615176152
Yes,Virginia,51,"Buchanan County",51027,377,150,527,0.715370019
Yes,Virginia,51,"Buckingham County",51029,224,75,299,0.7491638796
Yes,Virginia,51,"Campbell County",51031,509,155,664,0.7665662651
Yes,Virginia,51,"Caroline County",51033,240,63,303,0.7920792079
Yes,Virginia,51,"Carroll County",51035,425,107,532,0.7988721805
Yes,Virginia,51,"Charles City County",51036,57,14,71,0.8028169014
Yes,Virginia,51,"Charlotte County",51037,214,65,279,0.7670250896
Yes,Virginia,51,"Chesterfield County",51041,991,305,1296,0.7646604938
Yes,Virginia,51,"Clarke County",51043,79,20,99,0.797979798
Yes,Virginia,51,"Craig County",51045,.,.,.,0.8709677419
Yes,Virginia,51,"Culpeper County",51047,327,94,421,0.7767220903
Yes,Virginia,51,"Cumberland County",51049,113,32,145,0.7793103448
Yes,Virginia,51,"Dickenson County",51051,309,83,392,0.7882653061
Yes,Virginia,51,"Dinwiddie County",51053,200,79,279,0.7168458781
Yes,Virginia,51,"Essex County",51057,128,39,167,0.7664670659
Yes,Virginia,51,"Fairfax County",51059,2897,713,3610,0.8024930748
Yes,Virginia,51,"Fauquier County",51061,260,95,355,0.7323943662
Yes,Virginia,51,"Floyd County",51063,167,34,201,0.8308457711
Yes,Virginia,51,"Fluvanna County",51065,151,39,190,0.7947368421
Yes,Virginia,51,"Franklin County",51067,410,139,549,0.7468123862
Yes,Virginia,51,"Frederick County",51069,420,110,530,0.7924528302
Yes,Virginia,51,"Giles County",51071,205,68,273,0.7509157509
Yes,Virginia,51,"Gloucester County",51073,245,65,310,0.7903225806
Yes,Virginia,51,"Goochland County",51075,97,34,131,0.7404580153
Yes,Virginia,51,"Grayson County",51077,290,69,359,0.8077994429
Yes,Virginia,51,"Greene County",51079,117,33,150,0.78
Yes,Virginia,51,"Greensville County",51081,103,48,151,0.6821192053
Yes,Virginia,51,"Halifax County",51083,633,211,844,0.75
Yes,Virginia,51,"Hanover County",51085,270,84,354,0.7627118644
Yes,Virginia,51,"Henrico County",51087,1252,412,1664,0.7524038462
Yes,Virginia,51,"Henry County",51089,803,172,975,0.8235897436
Yes,Virginia,51,"Highland County",51091,.,.,.,0.7727272727
Yes,Virginia,51,"Isle of Wight County",51093,200,66,266,0.7518796992
Yes,Virginia,51,"James City County",51095,191,65,256,0.74609375
Yes,Virginia,51,"King and Queen County",51097,71,21,92,0.7717391304
Yes,Virginia,51,"King George County",51099,130,40,170,0.7647058824
Yes,Virginia,51,"King William County",51101,109,27,136,0.8014705882
Yes,Virginia,51,"Lancaster County",51103,141,46,187,0.7540106952
Yes,Virginia,51,"Lee County",51105,523,132,655,0.7984732824
Yes,Virginia,51,"Loudoun County",51107,758,228,986,0.7687626775
Yes,Virginia,51,"Louisa County",51109,287,76,363,0.7906336088
Yes,Virginia,51,"Lunenburg County",51111,194,75,269,0.7211895911
Yes,Virginia,51,"Madison County",51113,121,24,145,0.8344827586
Yes,Virginia,51,"Mathews County",51115,70,25,95,0.7368421053
Yes,Virginia,51,"Mecklenburg County",51117,506,179,685,0.7386861314
Yes,Virginia,51,"Middlesex County",51119,117,37,154,0.7597402597
Yes,Virginia,51,"Montgomery County",51121,436,135,571,0.7635726795
Yes,Virginia,51,"Nelson County",51125,154,26,180,0.8555555556
Yes,Virginia,51,"New Kent County",51127,72,23,95,0.7578947368
Yes,Virginia,51,"Northampton County",51131,223,81,304,0.7335526316
Yes,Virginia,51,"Northumberland County",51133,92,37,129,0.7131782946
Yes,Virginia,51,"Nottoway County",51135,205,71,276,0.7427536232
Yes,Virginia,51,"Orange County",51137,249,72,321,0.7757009346
Yes,Virginia,51,"Page County",51139,310,70,380,0.8157894737
Yes,Virginia,51,"Patrick County",51141,265,87,352,0.7528409091
Yes,Virginia,51,"Pittsylvania County",51143,723,218,941,0.7683315622
Yes,Virginia,51,"Powhatan County",51145,88,25,113,0.7787610619
Yes,Virginia,51,"Prince Edward County",51147,250,90,340,0.7352941176
Yes,Virginia,51,"Prince George County",51149,122,45,167,0.7305389222
Yes,Virginia,51,"Prince William County",51153,1171,392,1563,0.7492002559
Yes,Virginia,51,"Pulaski County",51155,434,136,570,0.7614035088
Yes,Virginia,51,"Rappahannock County",51157,57,11,68,0.8382352941
Yes,Virginia,51,"Richmond County",51159,96,16,112,0.8571428571
Yes,Virginia,51,"Roanoke County",51161,396,117,513,0.7719298246
Yes,Virginia,51,"Rockbridge County",51163,222,61,283,0.7844522968
Yes,Virginia,51,"Rockingham County",51165,531,136,667,0.796101949
Yes,Virginia,51,"Russell County",51167,441,120,561,0.7860962567
Yes,Virginia,51,"Scott County",51169,340,92,432,0.787037037
Yes,Virginia,51,"Shenandoah County",51171,375,104,479,0.7828810021
Yes,Virginia,51,"Smyth County",51173,544,161,705,0.7716312057
Yes,Virginia,51,"Southampton County",51175,166,71,237,0.7004219409
Yes,Virginia,51,"Spotsylvania County",51177,534,189,723,0.7385892116
Yes,Virginia,51,"Stafford County",51179,397,154,551,0.720508167
Yes,Virginia,51,"Surry County",51181,43,14,57,0.7543859649
Yes,Virginia,51,"Sussex County",51183,142,55,197,0.7208121827
Yes,Virginia,51,"Tazewell County",51185,571,216,787,0.7255400254
Yes,Virginia,51,"Warren County",51187,260,87,347,0.7492795389
Yes,Virginia,51,"Washington County",51191,598,168,766,0.7806788512
Yes,Virginia,51,"Westmoreland County",51193,224,67,291,0.7697594502
Yes,Virginia,51,"Wise County",51195,638,185,823,0.7752126367
Yes,Virginia,51,"Wythe County",51197,421,122,543,0.7753222836
Yes,Virginia,51,"York County",51199,163,50,213,0.765258216
Yes,Virginia,51,"Alexandria city",51510,455,141,596,0.7634228188
Yes,Virginia,51,"Bedford city",51515,.,0,.,1
Yes,Virginia,51,"Bristol city",51520,206,96,302,0.6821192053
Yes,Virginia,51,"Buena Vista city",51530,90,26,116,0.775862069
Yes,Virginia,51,"Charlottesville city",51540,280,83,363,0.7713498623
Yes,Virginia,51,"Chesapeake city",51550,785,357,1142,0.6873905429
Yes,Virginia,51,"Colonial Heights city",51570,113,46,159,0.7106918239
Yes,Virginia,51,"Covington city",51580,70,25,95,0.7368421053
Yes,Virginia,51,"Danville city",51590,682,306,988,0.6902834008
Yes,Virginia,51,"Emporia city",51595,106,46,152,0.6973684211
Yes,Virginia,51,"Fairfax city",51600,79,19,98,0.806122449
Yes,Virginia,51,"Falls Church city",51610,.,.,.,0.75
Yes,Virginia,51,"Franklin city",51620,116,68,184,0.6304347826
Yes,Virginia,51,"Fredericksburg city",51630,188,81,269,0.6988847584
Yes,Virginia,51,"Galax city",51640,147,56,203,0.724137931
Yes,Virginia,51,"Hampton city",51650,672,302,974,0.6899383984
Yes,Virginia,51,"Harrisonburg city",51660,214,78,292,0.7328767123
Yes,Virginia,51,"Hopewell city",51670,190,85,275,0.6909090909
Yes,Virginia,51,"Lexington city",51678,.,.,.,0.8529411765
Yes,Virginia,51,"Lynchburg city",51680,660,246,906,0.7284768212
Yes,Virginia,51,"Manassas city",51683,137,45,182,0.7527472527
Yes,Virginia,51,"Manassas Park city",51685,60,14,74,0.8108108108
Yes,Virginia,51,"Martinsville city",51690,314,86,400,0.785
Yes,Virginia,51,"Newport News city",51700,975,359,1334,0.7308845577
Yes,Virginia,51,"Norfolk city",51710,1336,538,1874,0.7129135539
Yes,Virginia,51,"Norton city",51720,97,22,119,0.8151260504
Yes,Virginia,51,"Petersburg city",51730,406,212,618,0.6569579288
Yes,Virginia,51,"Poquoson city",51735,.,.,.,0.75
Yes,Virginia,51,"Portsmouth city",51740,685,281,966,0.7091097308
Yes,Virginia,51,"Radford city",51750,78,28,106,0.7358490566
Yes,Virginia,51,"Richmond city",51760,1537,630,2167,0.7092754961
Yes,Virginia,51,"Roanoke city",51770,860,357,1217,0.7066557108
Yes,Virginia,51,"Salem city",51775,203,68,271,0.7490774908
Yes,Virginia,51,"Staunton city",51790,259,92,351,0.7378917379
Yes,Virginia,51,"Suffolk city",51800,599,208,807,0.7422552664
Yes,Virginia,51,"Virginia Beach city",51810,1526,531,2057,0.7418570734
Yes,Virginia,51,"Waynesboro city",51820,231,65,296,0.7804054054
Yes,Virginia,51,"Williamsburg city",51830,57,18,75,0.76
Yes,Virginia,51,"Winchester city",51840,214,71,285,0.750877193
Yes,Virginia,51,,51999,39,31,70,0.5571428571
Yes,Washington,53,"Adams County",53001,88,27,115,0.7652173913
Yes,Washington,53,"Asotin County",53003,184,61,245,0.7510204082
Yes,Washington,53,"Benton County",53005,981,319,1300,0.7546153846
Yes,Washington,53,"Chelan County",53007,415,120,535,0.7757009346
Yes,Washington,53,"Clallam County",53009,586,180,766,0.7650130548
Yes,Washington,53,"Clark County",53011,2009,519,2528,0.7946993671
Yes,Washington,53,"Columbia County",53013,52,17,69,0.7536231884
Yes,Washington,53,"Cowlitz County",53015,771,231,1002,0.7694610778
Yes,Washington,53,"Douglas County",53017,172,52,224,0.7678571429
Yes,Washington,53,"Ferry County",53019,63,21,84,0.75
Yes,Washington,53,"Franklin County",53021,414,127,541,0.7652495379
Yes,Washington,53,"Garfield County",53023,.,.,.,0.7666666667
Yes,Washington,53,"Grant County",53025,588,185,773,0.7606727038
Yes,Washington,53,"Grays Harbor County",53027,816,287,1103,0.739800544
Yes,Washington,53,"Island County",53029,317,88,405,0.7827160494
Yes,Washington,53,"Jefferson County",53031,237,64,301,0.7873754153
Yes,Washington,53,"King County",53033,7946,2196,10142,0.7834746598
Yes,Washington,53,"Kitsap County",53035,1148,329,1477,0.7772511848
Yes,Washington,53,"Kittitas County",53037,186,55,241,0.7717842324
Yes,Washington,53,"Klickitat County",53039,189,44,233,0.8111587983
Yes,Washington,53,"Lewis County",53041,561,199,760,0.7381578947
Yes,Washington,53,"Lincoln County",53043,83,26,109,0.7614678899
Yes,Washington,53,"Mason County",53045,424,122,546,0.7765567766
Yes,Washington,53,"Okanogan County",53047,314,103,417,0.7529976019
Yes,Washington,53,"Pacific County",53049,300,103,403,0.7444168734
Yes,Washington,53,"Pend Oreille County",53051,102,27,129,0.7906976744
Yes,Washington,53,"Pierce County",53053,4088,1354,5442,0.7511944138
Yes,Washington,53,"San Juan County",53055,62,19,81,0.7654320988
Yes,Washington,53,"Skagit County",53057,673,212,885,0.7604519774
Yes,Washington,53,"Skamania County",53059,71,22,93,0.7634408602
Yes,Washington,53,"Snohomish County",53061,3068,869,3937,0.7792735585
Yes,Washington,53,"Spokane County",53063,2296,802,3098,0.7411233054
Yes,Washington,53,"Stevens County",53065,337,117,454,0.7422907489
Yes,Washington,53,"Thurston County",53067,1149,392,1541,0.7456197274
Yes,Washington,53,"Wahkiakum County",53069,.,.,.,0.7619047619
Yes,Washington,53,"Walla Walla County",53071,427,119,546,0.7820512821
Yes,Washington,53,"Whatcom County",53073,1134,362,1496,0.7580213904
Yes,Washington,53,"Whitman County",53075,159,41,200,0.795
Yes,Washington,53,"Yakima County",53077,1668,588,2256,0.7393617021
Yes,Washington,53,,53999,31,16,47,0.6595744681
Yes,"West Virginia",54,"Barbour County",54001,339,74,413,0.8208232446
Yes,"West Virginia",54,"Berkeley County",54003,795,266,1061,0.7492931197
Yes,"West Virginia",54,"Boone County",54005,364,120,484,0.7520661157
Yes,"West Virginia",54,"Braxton County",54007,237,49,286,0.8286713287
Yes,"West Virginia",54,"Brooke County",54009,236,53,289,0.8166089965
Yes,"West Virginia",54,"Cabell County",54011,1043,366,1409,0.7402413059
Yes,"West Virginia",54,"Calhoun County",54013,189,37,226,0.8362831858
Yes,"West Virginia",54,"Clay County",54015,223,52,275,0.8109090909
Yes,"West Virginia",54,"Doddridge County",54017,97,14,111,0.8738738739
Yes,"West Virginia",54,"Fayette County",54019,755,187,942,0.8014861996
Yes,"West Virginia",54,"Gilmer County",54021,117,20,137,0.8540145985
Yes,"West Virginia",54,"Grant County",54023,209,47,256,0.81640625
Yes,"West Virginia",54,"Greenbrier County",54025,519,139,658,0.7887537994
Yes,"West Virginia",54,"Hampshire County",54027,334,69,403,0.8287841191
Yes,"West Virginia",54,"Hancock County",54029,282,70,352,0.8011363636
Yes,"West Virginia",54,"Hardy County",54031,219,49,268,0.8171641791
Yes,"West Virginia",54,"Harrison County",54033,771,200,971,0.7940267765
Yes,"West Virginia",54,"Jackson County",54035,382,117,499,0.7655310621
Yes,"West Virginia",54,"Jefferson County",54037,421,94,515,0.8174757282
Yes,"West Virginia",54,"Kanawha County",54039,2263,761,3024,0.7483465608
Yes,"West Virginia",54,"Lewis County",54041,286,52,338,0.8461538462
Yes,"West Virginia",54,"Lincoln County",54043,402,121,523,0.7686424474
Yes,"West Virginia",54,"Logan County",54045,623,198,821,0.7588306943
Yes,"West Virginia",54,"McDowell County",54047,529,187,716,0.7388268156
Yes,"West Virginia",54,"Marion County",54049,666,173,839,0.7938021454
Yes,"West Virginia",54,"Marshall County",54051,343,69,412,0.8325242718
Yes,"West Virginia",54,"Mason County",54053,413,148,561,0.7361853832
Yes,"West Virginia",54,"Mercer County",54055,1022,363,1385,0.7379061372
Yes,"West Virginia",54,"Mineral County",54057,439,84,523,0.8393881453
Yes,"West Virginia",54,"Mingo County",54059,610,187,797,0.765370138
Yes,"West Virginia",54,"Monongalia County",54061,567,136,703,0.8065433855
Yes,"West Virginia",54,"Monroe County",54063,183,35,218,0.8394495413
Yes,"West Virginia",54,"Morgan County",54065,196,56,252,0.7777777778
Yes,"West Virginia",54,"Nicholas County",54067,491,108,599,0.8196994992
Yes,"West Virginia",54,"Ohio County",54069,374,96,470,0.7957446809
Yes,"West Virginia",54,"Pendleton County",54071,126,28,154,0.8181818182
Yes,"West Virginia",54,"Pleasants County",54073,98,23,121,0.8099173554
Yes,"West Virginia",54,"Pocahontas County",54075,139,37,176,0.7897727273
Yes,"West Virginia",54,"Preston County",54077,493,120,613,0.8042414356
Yes,"West Virginia",54,"Putnam County",54079,485,173,658,0.7370820669
Yes,"West Virginia",54,"Raleigh County",54081,1016,355,1371,0.7410649161
Yes,"West Virginia",54,"Randolph County",54083,576,138,714,0.8067226891
Yes,"West Virginia",54,"Ritchie County",54085,163,39,202,0.8069306931
Yes,"West Virginia",54,"Roane County",54087,325,70,395,0.8227848101
Yes,"West Virginia",54,"Summers County",54089,253,95,348,0.7270114943
Yes,"West Virginia",54,"Taylor County",54091,254,61,315,0.8063492063
Yes,"West Virginia",54,"Tucker County",54093,133,25,158,0.8417721519
Yes,"West Virginia",54,"Tyler County",54095,122,20,142,0.8591549296
Yes,"West Virginia",54,"Upshur County",54097,363,76,439,0.8268792711
Yes,"West Virginia",54,"Wayne County",54099,610,235,845,0.7218934911
Yes,"West Virginia",54,"Webster County",54101,215,64,279,0.770609319
Yes,"West Virginia",54,"Wetzel County",54103,236,44,280,0.8428571429
Yes,"West Virginia",54,"Wirt County",54105,111,32,143,0.7762237762
Yes,"West Virginia",54,"Wood County",54107,1190,321,1511,0.7875579087
Yes,"West Virginia",54,"Wyoming County",54109,384,130,514,0.7470817121
Yes,"West Virginia",54,,54999,.,.,.,0.8064516129
Yes,Wisconsin,55,"Adams County",55001,274,56,330,0.8303030303
Yes,Wisconsin,55,"Ashland County",55003,185,48,233,0.7939914163
Yes,Wisconsin,55,"Barron County",55005,516,119,635,0.8125984252
Yes,Wisconsin,55,"Bayfield County",55007,158,27,185,0.8540540541
Yes,Wisconsin,55,"Brown County",55009,1054,212,1266,0.8325434439
Yes,Wisconsin,55,"Buffalo County",55011,134,16,150,0.8933333333
Yes,Wisconsin,55,"Burnett County",55013,143,42,185,0.772972973
Yes,Wisconsin,55,"Calumet County",55015,118,22,140,0.8428571429
Yes,Wisconsin,55,"Chippewa County",55017,490,97,587,0.8347529813
Yes,Wisconsin,55,"Clark County",55019,238,50,288,0.8263888889
Yes,Wisconsin,55,"Columbia County",55021,316,53,369,0.8563685637
Yes,Wisconsin,55,"Crawford County",55023,219,33,252,0.869047619
Yes,Wisconsin,55,"Dane County",55025,1813,388,2201,0.8237164925
Yes,Wisconsin,55,"Dodge County",55027,393,67,460,0.8543478261
Yes,Wisconsin,55,"Door County",55029,180,15,195,0.9230769231
Yes,Wisconsin,55,"Douglas County",55031,456,98,554,0.8231046931
Yes,Wisconsin,55,"Dunn County",55033,484,71,555,0.8720720721
Yes,Wisconsin,55,"Eau Claire County",55035,712,169,881,0.8081725312
Yes,Wisconsin,55,"Florence County",55037,46,19,65,0.7076923077
Yes,Wisconsin,55,"Fond du Lac County",55039,475,102,577,0.8232235702
Yes,Wisconsin,55,"Forest County",55041,100,26,126,0.7936507937
Yes,Wisconsin,55,"Grant County",55043,397,74,471,0.8428874735
Yes,Wisconsin,55,"Green County",55045,243,52,295,0.8237288136
Yes,Wisconsin,55,"Green Lake County",55047,98,26,124,0.7903225806
Yes,Wisconsin,55,"Iowa County",55049,151,32,183,0.825136612
Yes,Wisconsin,55,"Iron County",55051,77,23,100,0.77
Yes,Wisconsin,55,"Jackson County",55053,163,26,189,0.8624338624
Yes,Wisconsin,55,"Jefferson County",55055,492,85,577,0.8526863085
Yes,Wisconsin,55,"Juneau County",55057,314,73,387,0.811369509
Yes,Wisconsin,55,"Kenosha County",55059,896,246,1142,0.7845884413
Yes,Wisconsin,55,"Kewaunee County",55061,87,19,106,0.820754717
Yes,Wisconsin,55,"La Crosse County",55063,830,119,949,0.8746048472
Yes,Wisconsin,55,"Lafayette County",55065,137,17,154,0.8896103896
Yes,Wisconsin,55,"Langlade County",55067,232,43,275,0.8436363636
Yes,Wisconsin,55,"Lincoln County",55069,211,44,255,0.8274509804
Yes,Wisconsin,55,"Manitowoc County",55071,579,105,684,0.8464912281
Yes,Wisconsin,55,"Marathon County",55073,731,170,901,0.8113207547
Yes,Wisconsin,55,"Marinette County",55075,402,93,495,0.8121212121
Yes,Wisconsin,55,"Marquette County",55077,106,34,140,0.7571428571
Yes,Wisconsin,55,"Menominee County",55078,48,19,67,0.7164179104
Yes,Wisconsin,55,"Milwaukee County",55079,5974,1829,7803,0.7656029732
Yes,Wisconsin,55,"Monroe County",55081,387,60,447,0.8657718121
Yes,Wisconsin,55,"Oconto County",55083,217,58,275,0.7890909091
Yes,Wisconsin,55,"Oneida County",55085,328,72,400,0.82
Yes,Wisconsin,55,"Outagamie County",55087,559,123,682,0.8196480938
Yes,Wisconsin,55,"Ozaukee County",55089,270,46,316,0.8544303797
Yes,Wisconsin,55,"Pepin County",55091,114,16,130,0.8769230769
Yes,Wisconsin,55,"Pierce County",55093,192,31,223,0.8609865471
Yes,Wisconsin,55,"Polk County",55095,360,75,435,0.8275862069
Yes,Wisconsin,55,"Portage County",55097,420,82,502,0.8366533865
Yes,Wisconsin,55,"Price County",55099,152,32,184,0.8260869565
Yes,Wisconsin,55,"Racine County",55101,1049,326,1375,0.7629090909
Yes,Wisconsin,55,"Richland County",55103,188,32,220,0.8545454545
Yes,Wisconsin,55,"Rock County",55105,1134,267,1401,0.8094218415
Yes,Wisconsin,55,"Rusk County",55107,187,49,236,0.7923728814
Yes,Wisconsin,55,"St. Croix County",55109,338,78,416,0.8125
Yes,Wisconsin,55,"Sauk County",55111,421,84,505,0.8336633663
Yes,Wisconsin,55,"Sawyer County",55113,201,47,248,0.810483871
Yes,Wisconsin,55,"Shawano County",55115,224,54,278,0.8057553957
Yes,Wisconsin,55,"Sheboygan County",55117,517,118,635,0.8141732283
Yes,Wisconsin,55,"Taylor County",55119,140,33,173,0.8092485549
Yes,Wisconsin,55,"Trempealeau County",55121,246,33,279,0.8817204301
Yes,Wisconsin,55,"Vernon County",55123,278,35,313,0.8881789137
Yes,Wisconsin,55,"Vilas County",55125,204,65,269,0.7583643123
Yes,Wisconsin,55,"Walworth County",55127,444,108,552,0.8043478261
Yes,Wisconsin,55,"Washburn County",55129,174,41,215,0.8093023256
Yes,Wisconsin,55,"Washington County",55131,392,83,475,0.8252631579
Yes,Wisconsin,55,"Waukesha County",55133,1379,261,1640,0.8408536585
Yes,Wisconsin,55,"Waupaca County",55135,340,66,406,0.8374384236
Yes,Wisconsin,55,"Waushara County",55137,181,36,217,0.8341013825
Yes,Wisconsin,55,"Winnebago County",55139,695,166,861,0.8072009292
Yes,Wisconsin,55,"Wood County",55141,526,117,643,0.8180404355
Yes,Wisconsin,55,,55999,.,.,.,0.7272727273
Yes,Wyoming,56,"Albany County",56001,88,42,130,0.6769230769
Yes,Wyoming,56,"Big Horn County",56003,81,21,102,0.7941176471
Yes,Wyoming,56,"Campbell County",56005,165,51,216,0.7638888889
Yes,Wyoming,56,"Carbon County",56007,64,21,85,0.7529411765
Yes,Wyoming,56,"Converse County",56009,69,18,87,0.7931034483
Yes,Wyoming,56,"Crook County",56011,.,.,.,0.7857142857
Yes,Wyoming,56,"Fremont County",56013,214,77,291,0.735395189
Yes,Wyoming,56,"Goshen County",56015,98,30,128,0.765625
Yes,Wyoming,56,"Hot Springs County",56017,45,11,56,0.8035714286
Yes,Wyoming,56,"Johnson County",56019,43,13,56,0.7678571429
Yes,Wyoming,56,"Laramie County",56021,497,158,655,0.758778626
Yes,Wyoming,56,"Lincoln County",56023,41,14,55,0.7454545455
Yes,Wyoming,56,"Natrona County",56025,415,154,569,0.7293497364
Yes,Wyoming,56,"Niobrara County",56027,.,.,.,0.7777777778
Yes,Wyoming,56,"Park County",56029,150,37,187,0.8021390374
Yes,Wyoming,56,"Platte County",56031,59,28,87,0.6781609195
Yes,Wyoming,56,"Sheridan County",56033,125,37,162,0.7716049383
Yes,Wyoming,56,"Sublette County",56035,.,.,.,0.9090909091
Yes,Wyoming,56,"Sweetwater County",56037,128,49,177,0.7231638418
Yes,Wyoming,56,"Teton County",56039,.,.,.,0.6875
Yes,Wyoming,56,"Uinta County",56041,96,25,121,0.7933884298
Yes,Wyoming,56,"Washakie County",56043,57,22,79,0.7215189873
Yes,Wyoming,56,"Weston County",56045,.,.,.,0.8723404255
Yes,Wyoming,56,,56999,.,0,.,1
