RACE_NAME,SEX_NAME,STATE_NAME,STATE_FIPS,BENE_YES,BENE_NO,TOTAL_BENE,BENE_YES_PCT
Unknown,Male,Alabama,1,1097,166,1263,0.8685669042
Unknown,Male,Alaska,2,290,54,344,0.8430232558
Unknown,Male,Arizona,4,3034,435,3469,0.8746036322
Unknown,Male,Arkansas,5,706,125,831,0.8495788207
Unknown,Male,California,6,11988,1845,13833,0.8666232921
Unknown,Male,Colorado,8,2645,422,3067,0.8624062602
Unknown,Male,Connecticut,9,3034,437,3471,0.8740996831
Unknown,Male,Delaware,10,950,111,1061,0.8953817154
Unknown,Male,"District of Columbia",11,195,40,235,0.829787234
Unknown,Male,Florida,12,11101,1908,13009,0.8533323084
Unknown,Male,Georgia,13,3131,504,3635,0.8613480055
Unknown,Male,Hawaii,15,262,40,302,0.8675496689
Unknown,Male,Idaho,16,634,101,735,0.862585034
Unknown,Male,Illinois,17,6955,893,7848,0.8862130479
Unknown,Male,Indiana,18,4063,567,4630,0.877537797
Unknown,Male,Iowa,19,2297,250,2547,0.9018453082
Unknown,Male,Kansas,20,1593,206,1799,0.88549194
Unknown,Male,Kentucky,21,1670,246,1916,0.8716075157
Unknown,Male,Louisiana,22,1499,298,1797,0.8341680579
Unknown,Male,Maine,23,983,139,1122,0.876114082
Unknown,Male,Maryland,24,3396,523,3919,0.8665475887
Unknown,Male,Massachusetts,25,5607,800,6407,0.8751365694
Unknown,Male,Michigan,26,5469,831,6300,0.8680952381
Unknown,Male,Minnesota,27,2227,284,2511,0.8868976503
Unknown,Male,Mississippi,28,607,114,721,0.8418862691
Unknown,Male,Missouri,29,2435,344,2779,0.8762144656
Unknown,Male,Montana,30,650,93,743,0.8748317631
Unknown,Male,Nebraska,31,1346,168,1514,0.8890356671
Unknown,Male,Nevada,32,922,183,1105,0.8343891403
Unknown,Male,"New Hampshire",33,1396,139,1535,0.9094462541
Unknown,Male,"New Jersey",34,5502,938,6440,0.8543478261
Unknown,Male,"New Mexico",35,615,98,713,0.8625525947
Unknown,Male,"New York",36,11577,2113,13690,0.8456537619
Unknown,Male,"North Carolina",37,4399,736,5135,0.8566699124
Unknown,Male,"North Dakota",38,359,38,397,0.9042821159
Unknown,Male,Ohio,39,8851,1327,10178,0.8696207506
Unknown,Male,Oklahoma,40,980,155,1135,0.8634361233
Unknown,Male,Oregon,41,1574,236,1810,0.8696132597
Unknown,Male,Pennsylvania,42,7397,938,8335,0.8874625075
Unknown,Male,"Rhode Island",44,699,114,813,0.8597785978
Unknown,Male,"South Carolina",45,2822,409,3231,0.8734138038
Unknown,Male,"South Dakota",46,496,56,552,0.8985507246
Unknown,Male,Tennessee,47,2541,419,2960,0.8584459459
Unknown,Male,Texas,48,6365,1055,7420,0.8578167116
Unknown,Male,Utah,49,687,111,798,0.8609022556
Unknown,Male,Vermont,50,944,110,1054,0.8956356736
Unknown,Male,Virginia,51,4341,621,4962,0.8748488513
Unknown,Male,Washington,53,3035,513,3548,0.8554114994
Unknown,Male,"West Virginia",54,490,71,561,0.8734402852
Unknown,Male,Wisconsin,55,4177,459,4636,0.9009922347
Unknown,Male,Wyoming,56,353,63,416,0.8485576923
Unknown,Female,Alabama,1,432,82,514,0.8404669261
Unknown,Female,Alaska,2,117,28,145,0.8068965517
Unknown,Female,Arizona,4,1160,243,1403,0.8267997149
Unknown,Female,Arkansas,5,263,52,315,0.8349206349
Unknown,Female,California,6,7630,1257,8887,0.8585574435
Unknown,Female,Colorado,8,908,168,1076,0.843866171
Unknown,Female,Connecticut,9,1509,231,1740,0.8672413793
Unknown,Female,Delaware,10,444,71,515,0.8621359223
Unknown,Female,"District of Columbia",11,147,26,173,0.8497109827
Unknown,Female,Florida,12,4740,1002,5742,0.8254963427
Unknown,Female,Georgia,13,1173,258,1431,0.819706499
Unknown,Female,Hawaii,15,160,25,185,0.8648648649
Unknown,Female,Idaho,16,243,39,282,0.8617021277
Unknown,Female,Illinois,17,2858,464,3322,0.8603251054
Unknown,Female,Indiana,18,1607,225,1832,0.8771834061
Unknown,Female,Iowa,19,792,97,889,0.8908886389
Unknown,Female,Kansas,20,670,85,755,0.8874172185
Unknown,Female,Kentucky,21,562,119,681,0.825256975
Unknown,Female,Louisiana,22,572,109,681,0.8399412628
Unknown,Female,Maine,23,369,59,428,0.8621495327
Unknown,Female,Maryland,24,1987,428,2415,0.8227743271
Unknown,Female,Massachusetts,25,3670,670,4340,0.8456221198
Unknown,Female,Michigan,26,3049,500,3549,0.8591152437
Unknown,Female,Minnesota,27,1101,164,1265,0.8703557312
Unknown,Female,Mississippi,28,264,56,320,0.825
Unknown,Female,Missouri,29,954,165,1119,0.8525469169
Unknown,Female,Montana,30,228,34,262,0.8702290076
Unknown,Female,Nebraska,31,544,90,634,0.858044164
Unknown,Female,Nevada,32,471,86,557,0.8456014363
Unknown,Female,"New Hampshire",33,558,81,639,0.8732394366
Unknown,Female,"New Jersey",34,2875,598,3473,0.8278145695
Unknown,Female,"New Mexico",35,248,37,285,0.8701754386
Unknown,Female,"New York",36,7468,1803,9271,0.8055225973
Unknown,Female,"North Carolina",37,1614,312,1926,0.8380062305
Unknown,Female,"North Dakota",38,122,22,144,0.8472222222
Unknown,Female,Ohio,39,3346,615,3961,0.8447361777
Unknown,Female,Oklahoma,40,387,60,447,0.8657718121
Unknown,Female,Oregon,41,691,135,826,0.8365617433
Unknown,Female,Pennsylvania,42,3288,522,3810,0.862992126
Unknown,Female,"Rhode Island",44,390,72,462,0.8441558442
Unknown,Female,"South Carolina",45,1093,195,1288,0.8486024845
Unknown,Female,"South Dakota",46,186,24,210,0.8857142857
Unknown,Female,Tennessee,47,928,156,1084,0.8560885609
Unknown,Female,Texas,48,2479,515,2994,0.827989312
Unknown,Female,Utah,49,291,47,338,0.8609467456
Unknown,Female,Vermont,50,324,38,362,0.8950276243
Unknown,Female,Virginia,51,1781,282,2063,0.8633058652
Unknown,Female,Washington,53,1720,350,2070,0.8309178744
Unknown,Female,"West Virginia",54,155,34,189,0.8201058201
Unknown,Female,Wisconsin,55,1734,230,1964,0.882892057
Unknown,Female,Wyoming,56,132,22,154,0.8571428571
"Non-Hispanic White",Male,Alabama,1,71468,12711,84179,0.8490003445
"Non-Hispanic White",Male,Alaska,2,8294,1483,9777,0.8483174798
"Non-Hispanic White",Male,Arizona,4,89897,15075,104972,0.8563902755
"Non-Hispanic White",Male,Arkansas,5,51915,9897,61812,0.8398854591
"Non-Hispanic White",Male,California,6,286518,49403,335921,0.8529326836
"Non-Hispanic White",Male,Colorado,8,57572,9338,66910,0.8604393962
"Non-Hispanic White",Male,Connecticut,9,59347,8579,67926,0.873700792
"Non-Hispanic White",Male,Delaware,10,24559,3456,28015,0.8766375156
"Non-Hispanic White",Male,"District of Columbia",11,2377,442,2819,0.8432068109
"Non-Hispanic White",Male,Florida,12,311588,55155,366743,0.8496085815
"Non-Hispanic White",Male,Georgia,13,107571,20373,127944,0.8407662727
"Non-Hispanic White",Male,Hawaii,15,4733,888,5621,0.8420209927
"Non-Hispanic White",Male,Idaho,16,24612,4163,28775,0.8553258036
"Non-Hispanic White",Male,Illinois,17,207586,30731,238317,0.8710499041
"Non-Hispanic White",Male,Indiana,18,127502,20062,147564,0.8640454311
"Non-Hispanic White",Male,Iowa,19,78013,9766,87779,0.8887433213
"Non-Hispanic White",Male,Kansas,20,56760,7977,64737,0.8767783493
"Non-Hispanic White",Male,Kentucky,21,89609,18090,107699,0.8320318666
"Non-Hispanic White",Male,Louisiana,22,57168,11035,68203,0.8382035981
"Non-Hispanic White",Male,Maine,23,31658,4377,36035,0.8785347579
"Non-Hispanic White",Male,Maryland,24,73839,11644,85483,0.863785782
"Non-Hispanic White",Male,Massachusetts,25,132490,18568,151058,0.8770803268
"Non-Hispanic White",Male,Michigan,26,167983,28527,196510,0.8548318152
"Non-Hispanic White",Male,Minnesota,27,77437,9596,87033,0.8897429711
"Non-Hispanic White",Male,Mississippi,28,44444,9491,53935,0.8240289237
"Non-Hispanic White",Male,Missouri,29,109221,17325,126546,0.8630932625
"Non-Hispanic White",Male,Montana,30,20775,3296,24071,0.8630717461
"Non-Hispanic White",Male,Nebraska,31,38209,5238,43447,0.8794393169
"Non-Hispanic White",Male,Nevada,32,30247,5690,35937,0.8416673623
"Non-Hispanic White",Male,"New Hampshire",33,32971,4390,37361,0.8824977918
"Non-Hispanic White",Male,"New Jersey",34,139224,23532,162756,0.8554154686
"Non-Hispanic White",Male,"New Mexico",35,16929,3150,20079,0.8431196773
"Non-Hispanic White",Male,"New York",36,230383,41050,271433,0.8487656254
"Non-Hispanic White",Male,"North Carolina",37,156835,26789,183624,0.8541094846
"Non-Hispanic White",Male,"North Dakota",38,15443,1972,17415,0.8867642837
"Non-Hispanic White",Male,Ohio,39,194607,31872,226479,0.8592717206
"Non-Hispanic White",Male,Oklahoma,40,58417,10516,68933,0.8474460708
"Non-Hispanic White",Male,Oregon,41,53512,8694,62206,0.8602385622
"Non-Hispanic White",Male,Pennsylvania,42,210602,31682,242284,0.8692361031
"Non-Hispanic White",Male,"Rhode Island",44,16129,2301,18430,0.8751492132
"Non-Hispanic White",Male,"South Carolina",45,91849,16352,108201,0.8488738551
"Non-Hispanic White",Male,"South Dakota",46,18537,2534,21071,0.8797399269
"Non-Hispanic White",Male,Tennessee,47,108823,19188,128011,0.8501066315
"Non-Hispanic White",Male,Texas,48,256585,46356,302941,0.846980105
"Non-Hispanic White",Male,Utah,49,27737,4937,32674,0.8489012671
"Non-Hispanic White",Male,Vermont,50,17068,2250,19318,0.8835283156
"Non-Hispanic White",Male,Virginia,51,115252,18447,133699,0.862025894
"Non-Hispanic White",Male,Washington,53,90979,15090,106069,0.8577341165
"Non-Hispanic White",Male,"West Virginia",54,39139,7413,46552,0.8407587214
"Non-Hispanic White",Male,Wisconsin,55,100921,12055,112976,0.8932959213
"Non-Hispanic White",Male,Wyoming,56,10251,1683,11934,0.858974359
"Non-Hispanic White",Female,Alabama,1,82885,16939,99824,0.830311348
"Non-Hispanic White",Female,Alaska,2,7010,1355,8365,0.8380155409
"Non-Hispanic White",Female,Arizona,4,88731,16242,104973,0.8452744992
"Non-Hispanic White",Female,Arkansas,5,59855,12977,72832,0.8218228251
"Non-Hispanic White",Female,California,6,290684,54938,345622,0.8410459982
"Non-Hispanic White",Female,Colorado,8,55889,9836,65725,0.8503461392
"Non-Hispanic White",Female,Connecticut,9,69054,11420,80474,0.8580908119
"Non-Hispanic White",Female,Delaware,10,27515,4536,32051,0.8584755546
"Non-Hispanic White",Female,"District of Columbia",11,2060,410,2470,0.8340080972
"Non-Hispanic White",Female,Florida,12,325513,66636,392149,0.830074793
"Non-Hispanic White",Female,Georgia,13,119142,25611,144753,0.8230710244
"Non-Hispanic White",Female,Hawaii,15,3875,743,4618,0.8391078389
"Non-Hispanic White",Female,Idaho,16,24571,4338,28909,0.8499429243
"Non-Hispanic White",Female,Illinois,17,239735,40705,280440,0.854853088
"Non-Hispanic White",Female,Indiana,18,148276,26565,174841,0.8480619534
"Non-Hispanic White",Female,Iowa,19,91017,12323,103340,0.8807528547
"Non-Hispanic White",Female,Kansas,20,65961,10278,76239,0.865187109
"Non-Hispanic White",Female,Kentucky,21,102495,23272,125767,0.8149594091
"Non-Hispanic White",Female,Louisiana,22,64449,14149,78598,0.8199826968
"Non-Hispanic White",Female,Maine,23,35693,5016,40709,0.8767840035
"Non-Hispanic White",Female,Maryland,24,85073,15216,100289,0.8482784752
"Non-Hispanic White",Female,Massachusetts,25,150653,24087,174740,0.862155202
"Non-Hispanic White",Female,Michigan,26,183015,34539,217554,0.8412394164
"Non-Hispanic White",Female,Minnesota,27,85280,11148,96428,0.884390426
"Non-Hispanic White",Female,Mississippi,28,51699,12930,64629,0.7999350137
"Non-Hispanic White",Female,Missouri,29,122892,21827,144719,0.8491766803
"Non-Hispanic White",Female,Montana,30,20687,3363,24050,0.8601663202
"Non-Hispanic White",Female,Nebraska,31,46157,6828,52985,0.8711333396
"Non-Hispanic White",Female,Nevada,32,31157,6368,37525,0.8302998001
"Non-Hispanic White",Female,"New Hampshire",33,36253,5441,41694,0.8695016069
"Non-Hispanic White",Female,"New Jersey",34,161294,31584,192878,0.8362488205
"Non-Hispanic White",Female,"New Mexico",35,17307,3585,20892,0.8284032165
"Non-Hispanic White",Female,"New York",36,258564,53125,311689,0.8295576681
"Non-Hispanic White",Female,"North Carolina",37,173727,33987,207714,0.8363759785
"Non-Hispanic White",Female,"North Dakota",38,17945,2576,20521,0.8744700551
"Non-Hispanic White",Female,Ohio,39,217493,40408,257901,0.8433197235
"Non-Hispanic White",Female,Oklahoma,40,68295,13921,82216,0.830677727
"Non-Hispanic White",Female,Oregon,41,54870,9509,64379,0.8522965563
"Non-Hispanic White",Female,Pennsylvania,42,242191,40285,282476,0.8573861142
"Non-Hispanic White",Female,"Rhode Island",44,18971,3162,22133,0.8571364027
"Non-Hispanic White",Female,"South Carolina",45,98930,20600,119530,0.8276583285
"Non-Hispanic White",Female,"South Dakota",46,20766,3062,23828,0.8714957193
"Non-Hispanic White",Female,Tennessee,47,121401,24617,146018,0.8314111959
"Non-Hispanic White",Female,Texas,48,278315,57773,336088,0.8281015686
"Non-Hispanic White",Female,Utah,49,28051,5348,33399,0.8398754454
"Non-Hispanic White",Female,Vermont,50,17712,2486,20198,0.8769185068
"Non-Hispanic White",Female,Virginia,51,127788,23501,151289,0.8446615418
"Non-Hispanic White",Female,Washington,53,92734,16245,108979,0.8509345837
"Non-Hispanic White",Female,"West Virginia",54,45476,9725,55201,0.8238256553
"Non-Hispanic White",Female,Wisconsin,55,107119,14291,121410,0.8822914093
"Non-Hispanic White",Female,Wyoming,56,10479,1910,12389,0.8458309791
"Black or African-American",Male,Alabama,1,14941,4812,19753,0.7563914342
"Black or African-American",Male,Alaska,2,163,57,220,0.7409090909
"Black or African-American",Male,Arizona,4,2015,564,2579,0.7813105855
"Black or African-American",Male,Arkansas,5,5236,2078,7314,0.7158873393
"Black or African-American",Male,California,6,18078,5734,23812,0.7591970435
"Black or African-American",Male,Colorado,8,1274,372,1646,0.7739975699
"Black or African-American",Male,Connecticut,9,4168,1019,5187,0.8035473299
"Black or African-American",Male,Delaware,10,3182,856,4038,0.7880138683
"Black or African-American",Male,"District of Columbia",11,3638,1294,4932,0.7376317924
"Black or African-American",Male,Florida,12,23791,7808,31599,0.7529035729
"Black or African-American",Male,Georgia,13,24514,8228,32742,0.748701973
"Black or African-American",Male,Hawaii,15,123,25,148,0.8310810811
"Black or African-American",Male,Idaho,16,67,14,81,0.8271604938
"Black or African-American",Male,Illinois,17,20608,6857,27465,0.7503367923
"Black or African-American",Male,Indiana,18,6920,2130,9050,0.764640884
"Black or African-American",Male,Iowa,19,1045,326,1371,0.7622173596
"Black or African-American",Male,Kansas,20,1905,526,2431,0.7836281366
"Black or African-American",Male,Kentucky,21,4044,1349,5393,0.7498609308
"Black or African-American",Male,Louisiana,22,16507,6133,22640,0.7291077739
"Black or African-American",Male,Maine,23,158,37,195,0.8102564103
"Black or African-American",Male,Maryland,24,17789,5433,23222,0.7660408234
"Black or African-American",Male,Massachusetts,25,6017,1770,7787,0.7726980866
"Black or African-American",Male,Michigan,26,17339,6161,23500,0.7378297872
"Black or African-American",Male,Minnesota,27,2342,816,3158,0.741608613
"Black or African-American",Male,Mississippi,28,15142,5882,21024,0.7202245053
"Black or African-American",Male,Missouri,29,7127,2280,9407,0.7576272988
"Black or African-American",Male,Montana,30,41,11,52,0.7884615385
"Black or African-American",Male,Nebraska,31,805,212,1017,0.7915437561
"Black or African-American",Male,Nevada,32,2071,730,2801,0.7393787933
"Black or African-American",Male,"New Hampshire",33,162,48,210,0.7714285714
"Black or African-American",Male,"New Jersey",34,11986,3888,15874,0.7550711856
"Black or African-American",Male,"New Mexico",35,374,104,478,0.7824267782
"Black or African-American",Male,"New York",36,22256,7970,30226,0.7363197247
"Black or African-American",Male,"North Carolina",37,28933,9397,38330,0.7548395513
"Black or African-American",Male,"North Dakota",38,50,23,73,0.6849315068
"Black or African-American",Male,Ohio,39,15586,4899,20485,0.760849402
"Black or African-American",Male,Oklahoma,40,2660,886,3546,0.7501410039
"Black or African-American",Male,Oregon,41,627,203,830,0.7554216867
"Black or African-American",Male,Pennsylvania,42,13296,4187,17483,0.7605102099
"Black or African-American",Male,"Rhode Island",44,606,147,753,0.8047808765
"Black or African-American",Male,"South Carolina",45,17207,5892,23099,0.7449240227
"Black or African-American",Male,"South Dakota",46,59,26,85,0.6941176471
"Black or African-American",Male,Tennessee,47,9916,3264,13180,0.7523520486
"Black or African-American",Male,Texas,48,24987,8472,33459,0.7467945844
"Black or African-American",Male,Utah,49,124,48,172,0.7209302326
"Black or African-American",Male,Vermont,50,75,14,89,0.8426966292
"Black or African-American",Male,Virginia,51,18677,5239,23916,0.780941629
"Black or African-American",Male,Washington,53,2241,691,2932,0.764324693
"Black or African-American",Male,"West Virginia",54,882,286,1168,0.7551369863
"Black or African-American",Male,Wisconsin,55,3669,1005,4674,0.7849807445
"Black or African-American",Male,Wyoming,56,48,12,60,0.8
"Black or African-American",Female,Alabama,1,25331,7638,32969,0.7683278231
"Black or African-American",Female,Alaska,2,211,67,278,0.7589928058
"Black or African-American",Female,Arizona,4,2631,815,3446,0.763493906
"Black or African-American",Female,Arkansas,5,8547,3080,11627,0.7350993377
"Black or African-American",Female,California,6,25321,7632,32953,0.7683974145
"Black or African-American",Female,Colorado,8,1589,433,2022,0.7858555885
"Black or African-American",Female,Connecticut,9,6187,1635,7822,0.7909741754
"Black or African-American",Female,Delaware,10,5296,1438,6734,0.7864567865
"Black or African-American",Female,"District of Columbia",11,5688,1821,7509,0.7574910108
"Black or African-American",Female,Florida,12,35018,11446,46464,0.7536587466
"Black or African-American",Female,Georgia,13,40581,13216,53797,0.7543357436
"Black or African-American",Female,Hawaii,15,97,30,127,0.7637795276
"Black or African-American",Female,Idaho,16,59,19,78,0.7564102564
"Black or African-American",Female,Illinois,17,34280,11633,45913,0.7466294949
"Black or African-American",Female,Indiana,18,11061,3485,14546,0.7604152344
"Black or African-American",Female,Iowa,19,1332,388,1720,0.7744186047
"Black or African-American",Female,Kansas,20,2721,698,3419,0.7958467388
"Black or African-American",Female,Kentucky,21,6027,1990,8017,0.7517774729
"Black or African-American",Female,Louisiana,22,26928,9836,36764,0.7324556631
"Black or African-American",Female,Maine,23,91,24,115,0.7913043478
"Black or African-American",Female,Maryland,24,30492,9492,39984,0.762605042
"Black or African-American",Female,Massachusetts,25,8219,2282,10501,0.7826873631
"Black or African-American",Female,Michigan,26,27474,10159,37633,0.7300507533
"Black or African-American",Female,Minnesota,27,2540,886,3426,0.7413893754
"Black or African-American",Female,Mississippi,28,25390,9345,34735,0.7309630056
"Black or African-American",Female,Missouri,29,11220,3447,14667,0.764982614
"Black or African-American",Female,Montana,30,.,.,.,0.7727272727
"Black or African-American",Female,Nebraska,31,1135,319,1454,0.780605227
"Black or African-American",Female,Nevada,32,3315,1211,4526,0.732434821
"Black or African-American",Female,"New Hampshire",33,193,65,258,0.7480620155
"Black or African-American",Female,"New Jersey",34,20607,6884,27491,0.7495907752
"Black or African-American",Female,"New Mexico",35,404,130,534,0.7565543071
"Black or African-American",Female,"New York",36,36058,13399,49457,0.7290777847
"Black or African-American",Female,"North Carolina",37,47997,14512,62509,0.7678414308
"Black or African-American",Female,"North Dakota",38,53,16,69,0.768115942
"Black or African-American",Female,Ohio,39,23374,7330,30704,0.76126889
"Black or African-American",Female,Oklahoma,40,4337,1456,5793,0.7486621785
"Black or African-American",Female,Oregon,41,617,195,812,0.7598522167
"Black or African-American",Female,Pennsylvania,42,19650,6038,25688,0.7649486141
"Black or African-American",Female,"Rhode Island",44,778,206,984,0.7906504065
"Black or African-American",Female,"South Carolina",45,29504,10101,39605,0.7449564449
"Black or African-American",Female,"South Dakota",46,59,24,83,0.7108433735
"Black or African-American",Female,Tennessee,47,16866,5515,22381,0.7535856307
"Black or African-American",Female,Texas,48,43241,14491,57732,0.7489953579
"Black or African-American",Female,Utah,49,142,47,189,0.7513227513
"Black or African-American",Female,Vermont,50,44,13,57,0.7719298246
"Black or African-American",Female,Virginia,51,30290,8755,39045,0.7757715457
"Black or African-American",Female,Washington,53,2433,701,3134,0.7763241863
"Black or African-American",Female,"West Virginia",54,1183,376,1559,0.7588197563
"Black or African-American",Female,Wisconsin,55,5214,1416,6630,0.7864253394
"Black or African-American",Female,Wyoming,56,44,14,58,0.7586206897
Other,Male,Alabama,1,262,55,317,0.8264984227
Other,Male,Alaska,2,118,31,149,0.7919463087
Other,Male,Arizona,4,779,171,950,0.82
Other,Male,Arkansas,5,195,35,230,0.847826087
Other,Male,California,6,9338,1719,11057,0.8445328751
Other,Male,Colorado,8,459,81,540,0.85
Other,Male,Connecticut,9,714,117,831,0.8592057762
Other,Male,Delaware,10,232,27,259,0.8957528958
Other,Male,"District of Columbia",11,60,13,73,0.8219178082
Other,Male,Florida,12,3124,635,3759,0.8310720936
Other,Male,Georgia,13,802,167,969,0.8276573787
Other,Male,Hawaii,15,2338,357,2695,0.8675324675
Other,Male,Idaho,16,166,36,202,0.8217821782
Other,Male,Illinois,17,2517,503,3020,0.8334437086
Other,Male,Indiana,18,642,110,752,0.8537234043
Other,Male,Iowa,19,334,43,377,0.8859416446
Other,Male,Kansas,20,313,42,355,0.8816901408
Other,Male,Kentucky,21,348,57,405,0.8592592593
Other,Male,Louisiana,22,369,83,452,0.8163716814
Other,Male,Maine,23,222,30,252,0.880952381
Other,Male,Maryland,24,1034,248,1282,0.8065522621
Other,Male,Massachusetts,25,1829,302,2131,0.8582824965
Other,Male,Michigan,26,1776,363,2139,0.8302945302
Other,Male,Minnesota,27,674,106,780,0.8641025641
Other,Male,Mississippi,28,116,24,140,0.8285714286
Other,Male,Missouri,29,539,87,626,0.8610223642
Other,Male,Montana,30,110,25,135,0.8148148148
Other,Male,Nebraska,31,178,22,200,0.89
Other,Male,Nevada,32,692,133,825,0.8387878788
Other,Male,"New Hampshire",33,220,38,258,0.8527131783
Other,Male,"New Jersey",34,2257,475,2732,0.8261346999
Other,Male,"New Mexico",35,171,34,205,0.8341463415
Other,Male,"New York",36,4453,1061,5514,0.8075807037
Other,Male,"North Carolina",37,1500,293,1793,0.8365867262
Other,Male,"North Dakota",38,86,14,100,0.86
Other,Male,Ohio,39,1263,284,1547,0.8164188752
Other,Male,Oklahoma,40,324,64,388,0.8350515464
Other,Male,Oregon,41,491,84,575,0.8539130435
Other,Male,Pennsylvania,42,1369,265,1634,0.8378212974
Other,Male,"Rhode Island",44,232,51,283,0.8197879859
Other,Male,"South Carolina",45,455,72,527,0.8633776091
Other,Male,"South Dakota",46,74,16,90,0.8222222222
Other,Male,Tennessee,47,484,110,594,0.8148148148
Other,Male,Texas,48,2421,531,2952,0.8201219512
Other,Male,Utah,49,217,41,258,0.8410852713
Other,Male,Vermont,50,138,21,159,0.8679245283
Other,Male,Virginia,51,1258,240,1498,0.8397863818
Other,Male,Washington,53,1106,201,1307,0.8462127008
Other,Male,"West Virginia",54,176,35,211,0.8341232227
Other,Male,Wisconsin,55,547,74,621,0.8808373591
Other,Male,Wyoming,56,.,.,.,0.8913043478
Other,Female,Alabama,1,233,51,284,0.8204225352
Other,Female,Alaska,2,146,32,178,0.8202247191
Other,Female,Arizona,4,719,163,882,0.8151927438
Other,Female,Arkansas,5,128,35,163,0.7852760736
Other,Female,California,6,9124,1677,10801,0.8447365985
Other,Female,Colorado,8,383,56,439,0.8724373576
Other,Female,Connecticut,9,578,117,695,0.8316546763
Other,Female,Delaware,10,193,28,221,0.8733031674
Other,Female,"District of Columbia",11,81,11,92,0.8804347826
Other,Female,Florida,12,2408,547,2955,0.8148900169
Other,Female,Georgia,13,654,160,814,0.8034398034
Other,Female,Hawaii,15,2567,419,2986,0.8596784997
Other,Female,Idaho,16,134,32,166,0.8072289157
Other,Female,Illinois,17,2135,471,2606,0.8192632387
Other,Female,Indiana,18,471,106,577,0.8162911612
Other,Female,Iowa,19,239,40,279,0.8566308244
Other,Female,Kansas,20,237,39,276,0.8586956522
Other,Female,Kentucky,21,210,46,256,0.8203125
Other,Female,Louisiana,22,270,69,339,0.796460177
Other,Female,Maine,23,112,24,136,0.8235294118
Other,Female,Maryland,24,993,226,1219,0.8146021329
Other,Female,Massachusetts,25,1645,321,1966,0.8367243133
Other,Female,Michigan,26,1355,297,1652,0.8202179177
Other,Female,Minnesota,27,439,79,518,0.8474903475
Other,Female,Mississippi,28,142,23,165,0.8606060606
Other,Female,Missouri,29,371,55,426,0.8708920188
Other,Female,Montana,30,94,15,109,0.8623853211
Other,Female,Nebraska,31,132,29,161,0.8198757764
Other,Female,Nevada,32,740,164,904,0.8185840708
Other,Female,"New Hampshire",33,148,16,164,0.9024390244
Other,Female,"New Jersey",34,1992,526,2518,0.7911040508
Other,Female,"New Mexico",35,161,43,204,0.7892156863
Other,Female,"New York",36,4398,1179,5577,0.7885960194
Other,Female,"North Carolina",37,1339,307,1646,0.8134872418
Other,Female,"North Dakota",38,.,.,.,0.8412698413
Other,Female,Ohio,39,1029,217,1246,0.8258426966
Other,Female,Oklahoma,40,279,61,340,0.8205882353
Other,Female,Oregon,41,430,76,506,0.8498023715
Other,Female,Pennsylvania,42,1107,210,1317,0.840546697
Other,Female,"Rhode Island",44,230,37,267,0.861423221
Other,Female,"South Carolina",45,353,76,429,0.8228438228
Other,Female,"South Dakota",46,52,11,63,0.8253968254
Other,Female,Tennessee,47,343,79,422,0.8127962085
Other,Female,Texas,48,2081,468,2549,0.8163985877
Other,Female,Utah,49,200,46,246,0.8130081301
Other,Female,Vermont,50,71,16,87,0.816091954
Other,Female,Virginia,51,1051,222,1273,0.8256087981
Other,Female,Washington,53,1195,257,1452,0.8230027548
Other,Female,"West Virginia",54,99,17,116,0.8534482759
Other,Female,Wisconsin,55,425,58,483,0.8799171843
Other,Female,Wyoming,56,.,.,.,0.8333333333
"Asian/Pacific Islander",Male,Alabama,1,393,92,485,0.8103092784
"Asian/Pacific Islander",Male,Alaska,2,462,107,569,0.8119507909
"Asian/Pacific Islander",Male,Arizona,4,1613,333,1946,0.8288797533
"Asian/Pacific Islander",Male,Arkansas,5,309,90,399,0.7744360902
"Asian/Pacific Islander",Male,California,6,66268,13026,79294,0.8357252756
"Asian/Pacific Islander",Male,Colorado,8,1014,198,1212,0.8366336634
"Asian/Pacific Islander",Male,Connecticut,9,1436,255,1691,0.8492016558
"Asian/Pacific Islander",Male,Delaware,10,482,82,564,0.8546099291
"Asian/Pacific Islander",Male,"District of Columbia",11,154,23,177,0.8700564972
"Asian/Pacific Islander",Male,Florida,12,5232,1185,6417,0.8153342683
"Asian/Pacific Islander",Male,Georgia,13,3043,677,3720,0.8180107527
"Asian/Pacific Islander",Male,Hawaii,15,9100,1544,10644,0.8549417512
"Asian/Pacific Islander",Male,Idaho,16,197,34,231,0.8528138528
"Asian/Pacific Islander",Male,Illinois,17,8023,1568,9591,0.836513398
"Asian/Pacific Islander",Male,Indiana,18,916,196,1112,0.8237410072
"Asian/Pacific Islander",Male,Iowa,19,490,86,576,0.8506944444
"Asian/Pacific Islander",Male,Kansas,20,618,119,737,0.8385345997
"Asian/Pacific Islander",Male,Kentucky,21,367,106,473,0.7758985201
"Asian/Pacific Islander",Male,Louisiana,22,852,203,1055,0.8075829384
"Asian/Pacific Islander",Male,Maine,23,163,34,197,0.8274111675
"Asian/Pacific Islander",Male,Maryland,24,4554,1030,5584,0.8155444126
"Asian/Pacific Islander",Male,Massachusetts,25,4667,800,5467,0.8536674593
"Asian/Pacific Islander",Male,Michigan,26,2905,673,3578,0.8119060928
"Asian/Pacific Islander",Male,Minnesota,27,1511,341,1852,0.81587473
"Asian/Pacific Islander",Male,Mississippi,28,299,85,384,0.7786458333
"Asian/Pacific Islander",Male,Missouri,29,828,185,1013,0.8173741362
"Asian/Pacific Islander",Male,Montana,30,.,.,.,0.8904109589
"Asian/Pacific Islander",Male,Nebraska,31,284,41,325,0.8738461538
"Asian/Pacific Islander",Male,Nevada,32,2288,493,2781,0.8227256383
"Asian/Pacific Islander",Male,"New Hampshire",33,206,37,243,0.8477366255
"Asian/Pacific Islander",Male,"New Jersey",34,8812,1880,10692,0.8241676019
"Asian/Pacific Islander",Male,"New Mexico",35,240,49,289,0.830449827
"Asian/Pacific Islander",Male,"New York",36,14836,3142,17978,0.8252308377
"Asian/Pacific Islander",Male,"North Carolina",37,2104,477,2581,0.8151879117
"Asian/Pacific Islander",Male,"North Dakota",38,.,.,.,0.8888888889
"Asian/Pacific Islander",Male,Ohio,39,2133,447,2580,0.826744186
"Asian/Pacific Islander",Male,Oklahoma,40,619,155,774,0.7997416021
"Asian/Pacific Islander",Male,Oregon,41,1284,252,1536,0.8359375
"Asian/Pacific Islander",Male,Pennsylvania,42,4353,798,5151,0.8450786255
"Asian/Pacific Islander",Male,"Rhode Island",44,311,59,370,0.8405405405
"Asian/Pacific Islander",Male,"South Carolina",45,765,172,937,0.8164354322
"Asian/Pacific Islander",Male,"South Dakota",46,66,13,79,0.835443038
"Asian/Pacific Islander",Male,Tennessee,47,860,181,1041,0.8261287224
"Asian/Pacific Islander",Male,Texas,48,11768,2612,14380,0.8183588317
"Asian/Pacific Islander",Male,Utah,49,490,146,636,0.7704402516
"Asian/Pacific Islander",Male,Vermont,50,94,12,106,0.8867924528
"Asian/Pacific Islander",Male,Virginia,51,4965,1025,5990,0.8288814691
"Asian/Pacific Islander",Male,Washington,53,5980,1071,7051,0.8481066515
"Asian/Pacific Islander",Male,"West Virginia",54,125,28,153,0.8169934641
"Asian/Pacific Islander",Male,Wisconsin,55,1009,253,1262,0.7995245642
"Asian/Pacific Islander",Male,Wyoming,56,31,11,42,0.7380952381
"Asian/Pacific Islander",Female,Alabama,1,533,128,661,0.8063540091
"Asian/Pacific Islander",Female,Alaska,2,606,165,771,0.7859922179
"Asian/Pacific Islander",Female,Arizona,4,1951,416,2367,0.8242501056
"Asian/Pacific Islander",Female,Arkansas,5,392,114,506,0.7747035573
"Asian/Pacific Islander",Female,California,6,88477,17173,105650,0.8374538571
"Asian/Pacific Islander",Female,Colorado,8,1182,253,1435,0.8236933798
"Asian/Pacific Islander",Female,Connecticut,9,1448,307,1755,0.8250712251
"Asian/Pacific Islander",Female,Delaware,10,542,97,639,0.848200313
"Asian/Pacific Islander",Female,"District of Columbia",11,226,43,269,0.8401486989
"Asian/Pacific Islander",Female,Florida,12,6263,1521,7784,0.8045991778
"Asian/Pacific Islander",Female,Georgia,13,3331,698,4029,0.8267560189
"Asian/Pacific Islander",Female,Hawaii,15,11968,2024,13992,0.8553459119
"Asian/Pacific Islander",Female,Idaho,16,278,48,326,0.8527607362
"Asian/Pacific Islander",Female,Illinois,17,8963,1734,10697,0.8378984762
"Asian/Pacific Islander",Female,Indiana,18,1014,244,1258,0.8060413355
"Asian/Pacific Islander",Female,Iowa,19,678,133,811,0.8360049322
"Asian/Pacific Islander",Female,Kansas,20,777,153,930,0.835483871
"Asian/Pacific Islander",Female,Kentucky,21,457,128,585,0.7811965812
"Asian/Pacific Islander",Female,Louisiana,22,991,252,1243,0.7972646822
"Asian/Pacific Islander",Female,Maine,23,191,28,219,0.8721461187
"Asian/Pacific Islander",Female,Maryland,24,5906,1171,7077,0.8345344072
"Asian/Pacific Islander",Female,Massachusetts,25,5267,892,6159,0.855171294
"Asian/Pacific Islander",Female,Michigan,26,3164,777,3941,0.8028419183
"Asian/Pacific Islander",Female,Minnesota,27,1722,450,2172,0.7928176796
"Asian/Pacific Islander",Female,Mississippi,28,347,97,444,0.7815315315
"Asian/Pacific Islander",Female,Missouri,29,1038,229,1267,0.81925809
"Asian/Pacific Islander",Female,Montana,30,99,17,116,0.8534482759
"Asian/Pacific Islander",Female,Nebraska,31,344,56,400,0.86
"Asian/Pacific Islander",Female,Nevada,32,3445,802,4247,0.8111608194
"Asian/Pacific Islander",Female,"New Hampshire",33,242,45,287,0.8432055749
"Asian/Pacific Islander",Female,"New Jersey",34,10128,2161,12289,0.8241516804
"Asian/Pacific Islander",Female,"New Mexico",35,270,48,318,0.8490566038
"Asian/Pacific Islander",Female,"New York",36,19730,4005,23735,0.8312618496
"Asian/Pacific Islander",Female,"North Carolina",37,2477,530,3007,0.8237445959
"Asian/Pacific Islander",Female,"North Dakota",38,57,13,70,0.8142857143
"Asian/Pacific Islander",Female,Ohio,39,2167,496,2663,0.8137438979
"Asian/Pacific Islander",Female,Oklahoma,40,819,185,1004,0.8157370518
"Asian/Pacific Islander",Female,Oregon,41,1772,330,2102,0.8430066603
"Asian/Pacific Islander",Female,Pennsylvania,42,4926,994,5920,0.8320945946
"Asian/Pacific Islander",Female,"Rhode Island",44,378,72,450,0.84
"Asian/Pacific Islander",Female,"South Carolina",45,781,181,962,0.8118503119
"Asian/Pacific Islander",Female,"South Dakota",46,94,17,111,0.8468468468
"Asian/Pacific Islander",Female,Tennessee,47,1017,234,1251,0.8129496403
"Asian/Pacific Islander",Female,Texas,48,13828,3071,16899,0.8182732706
"Asian/Pacific Islander",Female,Utah,49,615,143,758,0.8113456464
"Asian/Pacific Islander",Female,Vermont,50,108,21,129,0.8372093023
"Asian/Pacific Islander",Female,Virginia,51,6114,1276,7390,0.8273342355
"Asian/Pacific Islander",Female,Washington,53,8243,1446,9689,0.8507585922
"Asian/Pacific Islander",Female,"West Virginia",54,156,34,190,0.8210526316
"Asian/Pacific Islander",Female,Wisconsin,55,1281,324,1605,0.7981308411
"Asian/Pacific Islander",Female,Wyoming,56,.,.,.,0.8301886792
Hispanic,Male,Alabama,1,471,143,614,0.7671009772
Hispanic,Male,Alaska,2,260,69,329,0.7902735562
Hispanic,Male,Arizona,4,9932,3055,12987,0.7647647648
Hispanic,Male,Arkansas,5,728,254,982,0.7413441955
Hispanic,Male,California,6,88287,25036,113323,0.7790739744
Hispanic,Male,Colorado,8,6051,1582,7633,0.7927420411
Hispanic,Male,Connecticut,9,4682,1259,5941,0.7880828143
Hispanic,Male,Delaware,10,638,177,815,0.7828220859
Hispanic,Male,"District of Columbia",11,340,118,458,0.7423580786
Hispanic,Male,Florida,12,38100,9263,47363,0.8044253954
Hispanic,Male,Georgia,13,2405,729,3134,0.767389917
Hispanic,Male,Hawaii,15,1122,235,1357,0.8268238762
Hispanic,Male,Idaho,16,1023,272,1295,0.78996139
Hispanic,Male,Illinois,17,15637,4584,20221,0.77330498
Hispanic,Male,Indiana,18,2403,623,3026,0.7941176471
Hispanic,Male,Iowa,19,783,193,976,0.8022540984
Hispanic,Male,Kansas,20,1777,437,2214,0.8026196929
Hispanic,Male,Kentucky,21,444,139,583,0.7615780446
Hispanic,Male,Louisiana,22,1541,360,1901,0.8106259863
Hispanic,Male,Maine,23,148,29,177,0.8361581921
Hispanic,Male,Maryland,24,2316,612,2928,0.7909836066
Hispanic,Male,Massachusetts,25,10006,2714,12720,0.7866352201
Hispanic,Male,Michigan,26,3533,912,4445,0.7948256468
Hispanic,Male,Minnesota,27,1007,227,1234,0.8160453809
Hispanic,Male,Mississippi,28,331,93,424,0.7806603774
Hispanic,Male,Missouri,29,1086,281,1367,0.7944403804
Hispanic,Male,Montana,30,215,45,260,0.8269230769
Hispanic,Male,Nebraska,31,844,245,1089,0.7750229568
Hispanic,Male,Nevada,32,3726,1215,4941,0.7540983607
Hispanic,Male,"New Hampshire",33,352,90,442,0.7963800905
Hispanic,Male,"New Jersey",34,13850,4327,18177,0.7619519173
Hispanic,Male,"New Mexico",35,9070,2468,11538,0.7860981106
Hispanic,Male,"New York",36,21363,6856,28219,0.757043127
Hispanic,Male,"North Carolina",37,2495,826,3321,0.751279735
Hispanic,Male,"North Dakota",38,83,24,107,0.7757009346
Hispanic,Male,Ohio,39,2951,769,3720,0.7932795699
Hispanic,Male,Oklahoma,40,1461,415,1876,0.7787846482
Hispanic,Male,Oregon,41,2008,568,2576,0.7795031056
Hispanic,Male,Pennsylvania,42,6400,1886,8286,0.7723871591
Hispanic,Male,"Rhode Island",44,1571,420,1991,0.7890507283
Hispanic,Male,"South Carolina",45,1002,292,1294,0.7743431221
Hispanic,Male,"South Dakota",46,102,32,134,0.7611940299
Hispanic,Male,Tennessee,47,887,247,1134,0.7821869489
Hispanic,Male,Texas,48,68262,20020,88282,0.7732267053
Hispanic,Male,Utah,49,1168,338,1506,0.775564409
Hispanic,Male,Vermont,50,.,.,.,0.9196428571
Hispanic,Male,Virginia,51,2249,618,2867,0.7844436693
Hispanic,Male,Washington,53,3913,1038,4951,0.7903453848
Hispanic,Male,"West Virginia",54,145,39,184,0.7880434783
Hispanic,Male,Wisconsin,55,2080,466,2546,0.8169677926
Hispanic,Male,Wyoming,56,409,100,509,0.8035363458
Hispanic,Female,Alabama,1,654,188,842,0.7767220903
Hispanic,Female,Alaska,2,309,81,390,0.7923076923
Hispanic,Female,Arizona,4,10413,3123,13536,0.7692819149
Hispanic,Female,Arkansas,5,954,327,1281,0.7447306792
Hispanic,Female,California,6,107766,31319,139085,0.7748211525
Hispanic,Female,Colorado,8,6972,1716,8688,0.8024861878
Hispanic,Female,Connecticut,9,5917,1586,7503,0.7886178862
Hispanic,Female,Delaware,10,770,269,1039,0.7410972089
Hispanic,Female,"District of Columbia",11,483,168,651,0.7419354839
Hispanic,Female,Florida,12,53728,14602,68330,0.7863017708
Hispanic,Female,Georgia,13,3059,1083,4142,0.7385321101
Hispanic,Female,Hawaii,15,1390,293,1683,0.82590612
Hispanic,Female,Idaho,16,1149,312,1461,0.7864476386
Hispanic,Female,Illinois,17,18724,5566,24290,0.7708522026
Hispanic,Female,Indiana,18,2950,824,3774,0.781664017
Hispanic,Female,Iowa,19,1051,297,1348,0.7796735905
Hispanic,Female,Kansas,20,2263,511,2774,0.8157894737
Hispanic,Female,Kentucky,21,618,222,840,0.7357142857
Hispanic,Female,Louisiana,22,1927,525,2452,0.7858890701
Hispanic,Female,Maine,23,188,35,223,0.8430493274
Hispanic,Female,Maryland,24,3615,1079,4694,0.7701320835
Hispanic,Female,Massachusetts,25,12360,3205,15565,0.7940893029
Hispanic,Female,Michigan,26,4238,1160,5398,0.7851055947
Hispanic,Female,Minnesota,27,1105,316,1421,0.7776213934
Hispanic,Female,Mississippi,28,405,146,551,0.7350272232
Hispanic,Female,Missouri,29,1415,369,1784,0.793161435
Hispanic,Female,Montana,30,250,56,306,0.8169934641
Hispanic,Female,Nebraska,31,952,327,1279,0.744331509
Hispanic,Female,Nevada,32,4938,1696,6634,0.7443473018
Hispanic,Female,"New Hampshire",33,403,109,512,0.787109375
Hispanic,Female,"New Jersey",34,19886,6300,26186,0.759413427
Hispanic,Female,"New Mexico",35,10034,2787,12821,0.7826222604
Hispanic,Female,"New York",36,34175,10719,44894,0.7612375819
Hispanic,Female,"North Carolina",37,3733,1116,4849,0.7698494535
Hispanic,Female,"North Dakota",38,120,32,152,0.7894736842
Hispanic,Female,Ohio,39,3418,852,4270,0.8004683841
Hispanic,Female,Oklahoma,40,1816,592,2408,0.7541528239
Hispanic,Female,Oregon,41,2296,695,2991,0.7676362421
Hispanic,Female,Pennsylvania,42,7705,2146,9851,0.782154096
Hispanic,Female,"Rhode Island",44,2053,558,2611,0.7862887782
Hispanic,Female,"South Carolina",45,1328,409,1737,0.7645365573
Hispanic,Female,"South Dakota",46,122,42,164,0.743902439
Hispanic,Female,Tennessee,47,1190,346,1536,0.7747395833
Hispanic,Female,Texas,48,86875,26060,112935,0.7692477974
Hispanic,Female,Utah,49,1458,437,1895,0.7693931398
Hispanic,Female,Vermont,50,103,22,125,0.824
Hispanic,Female,Virginia,51,3460,1000,4460,0.7757847534
Hispanic,Female,Washington,53,4780,1266,6046,0.7906053589
Hispanic,Female,"West Virginia",54,214,62,276,0.7753623188
Hispanic,Female,Wisconsin,55,2497,570,3067,0.8141506358
Hispanic,Female,Wyoming,56,485,112,597,0.8123953099
"American Indian / Alaska Native",Male,Alabama,1,89,39,128,0.6953125
"American Indian / Alaska Native",Male,Alaska,2,923,317,1240,0.7443548387
"American Indian / Alaska Native",Male,Arizona,4,1335,1065,2400,0.55625
"American Indian / Alaska Native",Male,Arkansas,5,177,50,227,0.7797356828
"American Indian / Alaska Native",Male,California,6,1199,403,1602,0.7484394507
"American Indian / Alaska Native",Male,Colorado,8,130,30,160,0.8125
"American Indian / Alaska Native",Male,Connecticut,9,30,13,43,0.6976744186
"American Indian / Alaska Native",Male,Delaware,10,.,.,.,0.8571428571
"American Indian / Alaska Native",Male,"District of Columbia",11,.,.,.,0.6666666667
"American Indian / Alaska Native",Male,Florida,12,184,53,237,0.776371308
"American Indian / Alaska Native",Male,Georgia,13,50,22,72,0.6944444444
"American Indian / Alaska Native",Male,Hawaii,15,.,.,.,0.8333333333
"American Indian / Alaska Native",Male,Idaho,16,91,52,143,0.6363636364
"American Indian / Alaska Native",Male,Illinois,17,83,28,111,0.7477477477
"American Indian / Alaska Native",Male,Indiana,18,47,11,58,0.8103448276
"American Indian / Alaska Native",Male,Iowa,19,54,31,85,0.6352941176
"American Indian / Alaska Native",Male,Kansas,20,178,74,252,0.7063492063
"American Indian / Alaska Native",Male,Kentucky,21,.,.,.,0.8181818182
"American Indian / Alaska Native",Male,Louisiana,22,75,17,92,0.8152173913
"American Indian / Alaska Native",Male,Maine,23,97,21,118,0.8220338983
"American Indian / Alaska Native",Male,Maryland,24,48,13,61,0.7868852459
"American Indian / Alaska Native",Male,Massachusetts,25,67,20,87,0.7701149425
"American Indian / Alaska Native",Male,Michigan,26,530,127,657,0.8066971081
"American Indian / Alaska Native",Male,Minnesota,27,504,160,664,0.7590361446
"American Indian / Alaska Native",Male,Mississippi,28,37,16,53,0.6981132075
"American Indian / Alaska Native",Male,Missouri,29,139,31,170,0.8176470588
"American Indian / Alaska Native",Male,Montana,30,433,202,635,0.6818897638
"American Indian / Alaska Native",Male,Nebraska,31,92,41,133,0.6917293233
"American Indian / Alaska Native",Male,Nevada,32,94,63,157,0.5987261146
"American Indian / Alaska Native",Male,"New Hampshire",33,.,.,.,0.7272727273
"American Indian / Alaska Native",Male,"New Jersey",34,58,23,81,0.7160493827
"American Indian / Alaska Native",Male,"New Mexico",35,822,538,1360,0.6044117647
"American Indian / Alaska Native",Male,"New York",36,350,101,451,0.7760532151
"American Indian / Alaska Native",Male,"North Carolina",37,943,307,1250,0.7544
"American Indian / Alaska Native",Male,"North Dakota",38,279,94,373,0.7479892761
"American Indian / Alaska Native",Male,Ohio,39,71,17,88,0.8068181818
"American Indian / Alaska Native",Male,Oklahoma,40,3226,1354,4580,0.7043668122
"American Indian / Alaska Native",Male,Oregon,41,345,95,440,0.7840909091
"American Indian / Alaska Native",Male,Pennsylvania,42,.,.,.,0.8676470588
"American Indian / Alaska Native",Male,"Rhode Island",44,.,.,.,0.7575757576
"American Indian / Alaska Native",Male,"South Carolina",45,68,25,93,0.7311827957
"American Indian / Alaska Native",Male,"South Dakota",46,298,156,454,0.6563876652
"American Indian / Alaska Native",Male,Tennessee,47,52,15,67,0.776119403
"American Indian / Alaska Native",Male,Texas,48,454,120,574,0.7909407666
"American Indian / Alaska Native",Male,Utah,49,110,49,159,0.6918238994
"American Indian / Alaska Native",Male,Vermont,50,.,.,.,0.7777777778
"American Indian / Alaska Native",Male,Virginia,51,.,.,.,0.8181818182
"American Indian / Alaska Native",Male,Washington,53,796,304,1100,0.7236363636
"American Indian / Alaska Native",Male,"West Virginia",54,.,.,.,0.7058823529
"American Indian / Alaska Native",Male,Wisconsin,55,506,133,639,0.7918622848
"American Indian / Alaska Native",Male,Wyoming,56,80,32,112,0.7142857143
"American Indian / Alaska Native",Female,Alabama,1,86,31,117,0.735042735
"American Indian / Alaska Native",Female,Alaska,2,972,375,1347,0.7216035635
"American Indian / Alaska Native",Female,Arizona,4,1654,1435,3089,0.5354483652
"American Indian / Alaska Native",Female,Arkansas,5,194,67,261,0.7432950192
"American Indian / Alaska Native",Female,California,6,1732,547,2279,0.7599824484
"American Indian / Alaska Native",Female,Colorado,8,160,57,217,0.7373271889
"American Indian / Alaska Native",Female,Connecticut,9,30,12,42,0.7142857143
"American Indian / Alaska Native",Female,Delaware,10,.,.,.,0.8636363636
"American Indian / Alaska Native",Female,"District of Columbia",11,.,0,.,1
"American Indian / Alaska Native",Female,Florida,12,293,66,359,0.8161559889
"American Indian / Alaska Native",Female,Georgia,13,72,25,97,0.7422680412
"American Indian / Alaska Native",Female,Hawaii,15,.,.,.,0.8947368421
"American Indian / Alaska Native",Female,Idaho,16,163,71,234,0.6965811966
"American Indian / Alaska Native",Female,Illinois,17,110,31,141,0.780141844
"American Indian / Alaska Native",Female,Indiana,18,68,20,88,0.7727272727
"American Indian / Alaska Native",Female,Iowa,19,98,43,141,0.695035461
"American Indian / Alaska Native",Female,Kansas,20,289,98,387,0.7467700258
"American Indian / Alaska Native",Female,Kentucky,21,.,.,.,0.8292682927
"American Indian / Alaska Native",Female,Louisiana,22,76,24,100,0.76
"American Indian / Alaska Native",Female,Maine,23,80,15,95,0.8421052632
"American Indian / Alaska Native",Female,Maryland,24,61,21,82,0.743902439
"American Indian / Alaska Native",Female,Massachusetts,25,84,27,111,0.7567567568
"American Indian / Alaska Native",Female,Michigan,26,658,166,824,0.7985436893
"American Indian / Alaska Native",Female,Minnesota,27,700,258,958,0.7306889353
"American Indian / Alaska Native",Female,Mississippi,28,52,36,88,0.5909090909
"American Indian / Alaska Native",Female,Missouri,29,161,64,225,0.7155555556
"American Indian / Alaska Native",Female,Montana,30,576,278,854,0.6744730679
"American Indian / Alaska Native",Female,Nebraska,31,162,72,234,0.6923076923
"American Indian / Alaska Native",Female,Nevada,32,182,96,278,0.654676259
"American Indian / Alaska Native",Female,"New Hampshire",33,.,.,.,0.6875
"American Indian / Alaska Native",Female,"New Jersey",34,72,22,94,0.7659574468
"American Indian / Alaska Native",Female,"New Mexico",35,1029,777,1806,0.5697674419
"American Indian / Alaska Native",Female,"New York",36,580,166,746,0.7774798928
"American Indian / Alaska Native",Female,"North Carolina",37,1196,457,1653,0.7235329704
"American Indian / Alaska Native",Female,"North Dakota",38,360,121,481,0.7484407484
"American Indian / Alaska Native",Female,Ohio,39,76,23,99,0.7676767677
"American Indian / Alaska Native",Female,Oklahoma,40,4337,2026,6363,0.6815967311
"American Indian / Alaska Native",Female,Oregon,41,405,160,565,0.7168141593
"American Indian / Alaska Native",Female,Pennsylvania,42,58,19,77,0.7532467532
"American Indian / Alaska Native",Female,"Rhode Island",44,.,.,.,0.8684210526
"American Indian / Alaska Native",Female,"South Carolina",45,72,28,100,0.72
"American Indian / Alaska Native",Female,"South Dakota",46,398,270,668,0.5958083832
"American Indian / Alaska Native",Female,Tennessee,47,74,22,96,0.7708333333
"American Indian / Alaska Native",Female,Texas,48,650,191,841,0.7728894174
"American Indian / Alaska Native",Female,Utah,49,157,72,229,0.6855895197
"American Indian / Alaska Native",Female,Vermont,50,.,.,.,0.8888888889
"American Indian / Alaska Native",Female,Virginia,51,72,23,95,0.7578947368
"American Indian / Alaska Native",Female,Washington,53,1030,347,1377,0.7480029049
"American Indian / Alaska Native",Female,"West Virginia",54,.,.,.,0.8
"American Indian / Alaska Native",Female,Wisconsin,55,692,205,897,0.7714604236
"American Indian / Alaska Native",Female,Wyoming,56,116,35,151,0.7682119205
,,,,0,0,0,0
