RACE_NAME,SEX_NAME,STATE_NAME,STATE_FIPS,BENE_YES,BENE_NO,TOTAL_BENE,BENE_YES_PCT
Unknown,Male,Alabama,1,592,109,701,0.8445078459
Unknown,Male,Alaska,2,151,26,177,0.8531073446
Unknown,Male,Arizona,4,1489,235,1724,0.8636890951
Unknown,Male,Arkansas,5,434,122,556,0.7805755396
Unknown,Male,California,6,5662,945,6607,0.8569698804
Unknown,Male,Colorado,8,1039,193,1232,0.8433441558
Unknown,Male,Connecticut,9,1554,231,1785,0.8705882353
Unknown,Male,Delaware,10,433,67,500,0.866
Unknown,Male,"District of Columbia",11,69,15,84,0.8214285714
Unknown,Male,Florida,12,5672,956,6628,0.8557634279
Unknown,Male,Georgia,13,1603,299,1902,0.8427970557
Unknown,Male,Hawaii,15,111,21,132,0.8409090909
Unknown,Male,Idaho,16,304,61,365,0.8328767123
Unknown,Male,Illinois,17,3912,562,4474,0.8743853375
Unknown,Male,Indiana,18,2384,312,2696,0.884272997
Unknown,Male,Iowa,19,1239,137,1376,0.9004360465
Unknown,Male,Kansas,20,789,143,932,0.8465665236
Unknown,Male,Kentucky,21,951,190,1141,0.833479404
Unknown,Male,Louisiana,22,796,178,974,0.81724846
Unknown,Male,Maine,23,491,90,581,0.8450946644
Unknown,Male,Maryland,24,1743,254,1997,0.8728092138
Unknown,Male,Massachusetts,25,2899,456,3355,0.8640834575
Unknown,Male,Michigan,26,3252,464,3716,0.8751345533
Unknown,Male,Minnesota,27,1232,187,1419,0.8682170543
Unknown,Male,Mississippi,28,336,90,426,0.7887323944
Unknown,Male,Missouri,29,1365,219,1584,0.8617424242
Unknown,Male,Montana,30,333,52,385,0.8649350649
Unknown,Male,Nebraska,31,773,110,883,0.8754246886
Unknown,Male,Nevada,32,473,96,569,0.8312829525
Unknown,Male,"New Hampshire",33,702,84,786,0.893129771
Unknown,Male,"New Jersey",34,3122,429,3551,0.8791889609
Unknown,Male,"New Mexico",35,275,54,329,0.8358662614
Unknown,Male,"New York",36,6749,1143,7892,0.8551697922
Unknown,Male,"North Carolina",37,2214,370,2584,0.8568111455
Unknown,Male,"North Dakota",38,208,30,238,0.8739495798
Unknown,Male,Ohio,39,5048,717,5765,0.8756287944
Unknown,Male,Oklahoma,40,585,143,728,0.8035714286
Unknown,Male,Oregon,41,817,164,981,0.8328236493
Unknown,Male,Pennsylvania,42,4029,524,4553,0.8849110477
Unknown,Male,"Rhode Island",44,378,41,419,0.9021479714
Unknown,Male,"South Carolina",45,1338,184,1522,0.8791064389
Unknown,Male,"South Dakota",46,248,31,279,0.8888888889
Unknown,Male,Tennessee,47,1364,215,1579,0.8638378721
Unknown,Male,Texas,48,3257,629,3886,0.8381369017
Unknown,Male,Utah,49,300,65,365,0.8219178082
Unknown,Male,Vermont,50,436,55,491,0.8879837067
Unknown,Male,Virginia,51,2030,326,2356,0.8616298812
Unknown,Male,Washington,53,1515,275,1790,0.8463687151
Unknown,Male,"West Virginia",54,299,64,363,0.8236914601
Unknown,Male,Wisconsin,55,2270,263,2533,0.8961705488
Unknown,Male,Wyoming,56,160,31,191,0.8376963351
Unknown,Female,Alabama,1,277,58,335,0.8268656716
Unknown,Female,Alaska,2,71,11,82,0.8658536585
Unknown,Female,Arizona,4,569,112,681,0.8355359765
Unknown,Female,Arkansas,5,166,43,209,0.7942583732
Unknown,Female,California,6,4263,698,4961,0.85930256
Unknown,Female,Colorado,8,401,63,464,0.8642241379
Unknown,Female,Connecticut,9,744,115,859,0.8661233993
Unknown,Female,Delaware,10,201,30,231,0.8701298701
Unknown,Female,"District of Columbia",11,.,.,.,0.875
Unknown,Female,Florida,12,2488,477,2965,0.8391231029
Unknown,Female,Georgia,13,613,152,765,0.8013071895
Unknown,Female,Hawaii,15,.,.,.,0.8684210526
Unknown,Female,Idaho,16,130,23,153,0.8496732026
Unknown,Female,Illinois,17,1615,252,1867,0.8650241028
Unknown,Female,Indiana,18,885,144,1029,0.860058309
Unknown,Female,Iowa,19,457,57,514,0.8891050584
Unknown,Female,Kansas,20,288,41,329,0.8753799392
Unknown,Female,Kentucky,21,328,71,399,0.8220551378
Unknown,Female,Louisiana,22,350,88,438,0.799086758
Unknown,Female,Maine,23,229,33,262,0.8740458015
Unknown,Female,Maryland,24,1028,218,1246,0.8250401284
Unknown,Female,Massachusetts,25,1967,311,2278,0.863476734
Unknown,Female,Michigan,26,1955,254,2209,0.8850158443
Unknown,Female,Minnesota,27,583,121,704,0.828125
Unknown,Female,Mississippi,28,162,41,203,0.7980295567
Unknown,Female,Missouri,29,534,110,644,0.8291925466
Unknown,Female,Montana,30,123,20,143,0.8601398601
Unknown,Female,Nebraska,31,319,39,358,0.8910614525
Unknown,Female,Nevada,32,242,52,294,0.8231292517
Unknown,Female,"New Hampshire",33,325,37,362,0.8977900552
Unknown,Female,"New Jersey",34,1668,268,1936,0.8615702479
Unknown,Female,"New Mexico",35,118,20,138,0.8550724638
Unknown,Female,"New York",36,4675,928,5603,0.8343744423
Unknown,Female,"North Carolina",37,815,204,1019,0.7998037291
Unknown,Female,"North Dakota",38,83,17,100,0.83
Unknown,Female,Ohio,39,1981,316,2297,0.8624292556
Unknown,Female,Oklahoma,40,229,44,273,0.8388278388
Unknown,Female,Oregon,41,330,85,415,0.7951807229
Unknown,Female,Pennsylvania,42,1821,270,2091,0.8708751793
Unknown,Female,"Rhode Island",44,201,36,237,0.8481012658
Unknown,Female,"South Carolina",45,487,96,583,0.8353344768
Unknown,Female,"South Dakota",46,102,12,114,0.8947368421
Unknown,Female,Tennessee,47,495,97,592,0.8361486486
Unknown,Female,Texas,48,1323,345,1668,0.7931654676
Unknown,Female,Utah,49,95,32,127,0.7480314961
Unknown,Female,Vermont,50,167,24,191,0.8743455497
Unknown,Female,Virginia,51,788,157,945,0.8338624339
Unknown,Female,Washington,53,1075,179,1254,0.8572567783
Unknown,Female,"West Virginia",54,121,20,141,0.8581560284
Unknown,Female,Wisconsin,55,947,113,1060,0.8933962264
Unknown,Female,Wyoming,56,67,11,78,0.858974359
"Non-Hispanic White",Male,Alabama,1,46372,9357,55729,0.8320981895
"Non-Hispanic White",Male,Alaska,2,5080,843,5923,0.8576734763
"Non-Hispanic White",Male,Arizona,4,51878,9320,61198,0.8477074414
"Non-Hispanic White",Male,Arkansas,5,35738,8240,43978,0.8126335895
"Non-Hispanic White",Male,California,6,155025,30647,185672,0.8349401094
"Non-Hispanic White",Male,Colorado,8,28410,5358,33768,0.8413290689
"Non-Hispanic White",Male,Connecticut,9,36993,5325,42318,0.8741670211
"Non-Hispanic White",Male,Delaware,10,14495,2132,16627,0.8717748241
"Non-Hispanic White",Male,"District of Columbia",11,1062,178,1240,0.8564516129
"Non-Hispanic White",Male,Florida,12,188016,33552,221568,0.8485701906
"Non-Hispanic White",Male,Georgia,13,67842,14263,82105,0.8262834176
"Non-Hispanic White",Male,Hawaii,15,2482,542,3024,0.8207671958
"Non-Hispanic White",Male,Idaho,16,14126,2720,16846,0.8385373382
"Non-Hispanic White",Male,Illinois,17,137309,20783,158092,0.8685385725
"Non-Hispanic White",Male,Indiana,18,85010,13663,98673,0.8615325368
"Non-Hispanic White",Male,Iowa,19,50224,6695,56919,0.8823767108
"Non-Hispanic White",Male,Kansas,20,33301,5888,39189,0.8497537574
"Non-Hispanic White",Male,Kentucky,21,63303,13606,76909,0.8230896254
"Non-Hispanic White",Male,Louisiana,22,36439,7888,44327,0.8220497665
"Non-Hispanic White",Male,Maine,23,20492,3025,23517,0.8713696475
"Non-Hispanic White",Male,Maryland,24,45146,6987,52133,0.8659774039
"Non-Hispanic White",Male,Massachusetts,25,81794,11357,93151,0.8780796771
"Non-Hispanic White",Male,Michigan,26,113401,18580,131981,0.8592221608
"Non-Hispanic White",Male,Minnesota,27,49884,6452,56336,0.885472877
"Non-Hispanic White",Male,Mississippi,28,29086,6876,35962,0.8087981759
"Non-Hispanic White",Male,Missouri,29,71796,12875,84671,0.8479408534
"Non-Hispanic White",Male,Montana,30,12625,2247,14872,0.8489107047
"Non-Hispanic White",Male,Nebraska,31,25502,3951,29453,0.8658540726
"Non-Hispanic White",Male,Nevada,32,16684,3567,20251,0.8238605501
"Non-Hispanic White",Male,"New Hampshire",33,20588,2933,23521,0.8753029208
"Non-Hispanic White",Male,"New Jersey",34,91109,14218,105327,0.8650108709
"Non-Hispanic White",Male,"New Mexico",35,10197,2110,12307,0.8285528561
"Non-Hispanic White",Male,"New York",36,152058,25264,177322,0.857524729
"Non-Hispanic White",Male,"North Carolina",37,95177,17299,112476,0.8461983001
"Non-Hispanic White",Male,"North Dakota",38,10354,1281,11635,0.8899011603
"Non-Hispanic White",Male,Ohio,39,131669,22558,154227,0.8537350788
"Non-Hispanic White",Male,Oklahoma,40,39526,8876,48402,0.816619148
"Non-Hispanic White",Male,Oregon,41,31938,6208,38146,0.8372568552
"Non-Hispanic White",Male,Pennsylvania,42,136068,21083,157151,0.8658424063
"Non-Hispanic White",Male,"Rhode Island",44,9975,1566,11541,0.8643098518
"Non-Hispanic White",Male,"South Carolina",45,52620,9875,62495,0.841987359
"Non-Hispanic White",Male,"South Dakota",46,12606,1703,14309,0.8809839961
"Non-Hispanic White",Male,Tennessee,47,69358,13713,83071,0.8349243418
"Non-Hispanic White",Male,Texas,48,158275,32472,190747,0.829764033
"Non-Hispanic White",Male,Utah,49,13366,2857,16223,0.8238920052
"Non-Hispanic White",Male,Vermont,50,10254,1533,11787,0.8699414609
"Non-Hispanic White",Male,Virginia,51,69310,12066,81376,0.8517253244
"Non-Hispanic White",Male,Washington,53,53069,9309,62378,0.8507646927
"Non-Hispanic White",Male,"West Virginia",54,29225,5697,34922,0.8368650135
"Non-Hispanic White",Male,Wisconsin,55,64121,8017,72138,0.888865785
"Non-Hispanic White",Male,Wyoming,56,6132,1164,7296,0.8404605263
"Non-Hispanic White",Female,Alabama,1,61342,12442,73784,0.8313726553
"Non-Hispanic White",Female,Alaska,2,4811,792,5603,0.8586471533
"Non-Hispanic White",Female,Arizona,4,56781,10112,66893,0.8488332112
"Non-Hispanic White",Female,Arkansas,5,47022,10674,57696,0.8149958403
"Non-Hispanic White",Female,California,6,180996,34182,215178,0.8411454703
"Non-Hispanic White",Female,Colorado,8,32090,5893,37983,0.8448516442
"Non-Hispanic White",Female,Connecticut,9,46711,6235,52946,0.8822385072
"Non-Hispanic White",Female,Delaware,10,16376,2302,18678,0.8767533997
"Non-Hispanic White",Female,"District of Columbia",11,914,167,1081,0.8455134135
"Non-Hispanic White",Female,Florida,12,211478,37699,249177,0.84870594
"Non-Hispanic White",Female,Georgia,13,84566,17383,101949,0.829493178
"Non-Hispanic White",Female,Hawaii,15,2404,490,2894,0.8306841742
"Non-Hispanic White",Female,Idaho,16,16325,3078,19403,0.8413647374
"Non-Hispanic White",Female,Illinois,17,173392,26085,199477,0.8692330444
"Non-Hispanic White",Female,Indiana,18,108701,17632,126333,0.8604323494
"Non-Hispanic White",Female,Iowa,19,63671,7910,71581,0.8894958159
"Non-Hispanic White",Female,Kansas,20,43191,7179,50370,0.8574746873
"Non-Hispanic White",Female,Kentucky,21,81283,17380,98663,0.823844805
"Non-Hispanic White",Female,Louisiana,22,45943,10019,55962,0.8209677996
"Non-Hispanic White",Female,Maine,23,25299,3437,28736,0.880393931
"Non-Hispanic White",Female,Maryland,24,55806,8769,64575,0.8642044135
"Non-Hispanic White",Female,Massachusetts,25,98564,13135,111699,0.8824071836
"Non-Hispanic White",Female,Michigan,26,135544,21231,156775,0.8645766225
"Non-Hispanic White",Female,Minnesota,27,61736,7226,68962,0.8952176561
"Non-Hispanic White",Female,Mississippi,28,38638,8826,47464,0.8140485421
"Non-Hispanic White",Female,Missouri,29,88571,15546,104117,0.8506872077
"Non-Hispanic White",Female,Montana,30,14162,2216,16378,0.8646965441
"Non-Hispanic White",Female,Nebraska,31,34401,4865,39266,0.8761014618
"Non-Hispanic White",Female,Nevada,32,17997,3623,21620,0.8324236818
"Non-Hispanic White",Female,"New Hampshire",33,24250,3327,27577,0.8793559851
"Non-Hispanic White",Female,"New Jersey",34,111367,17063,128430,0.8671416336
"Non-Hispanic White",Female,"New Mexico",35,11577,2371,13948,0.8300114712
"Non-Hispanic White",Female,"New York",36,185410,29093,214503,0.8643701953
"Non-Hispanic White",Female,"North Carolina",37,118296,21552,139848,0.8458898232
"Non-Hispanic White",Female,"North Dakota",38,13334,1514,14848,0.8980334052
"Non-Hispanic White",Female,Ohio,39,160474,26401,186875,0.8587237458
"Non-Hispanic White",Female,Oklahoma,40,51289,11422,62711,0.8178628949
"Non-Hispanic White",Female,Oregon,41,37510,6739,44249,0.8477027729
"Non-Hispanic White",Female,Pennsylvania,42,165749,23650,189399,0.8751313365
"Non-Hispanic White",Female,"Rhode Island",44,12435,1679,14114,0.881040102
"Non-Hispanic White",Female,"South Carolina",45,61811,11662,73473,0.8412750262
"Non-Hispanic White",Female,"South Dakota",46,15874,2015,17889,0.8873609481
"Non-Hispanic White",Female,Tennessee,47,86836,17135,103971,0.8351944292
"Non-Hispanic White",Female,Texas,48,194539,40986,235525,0.8259802569
"Non-Hispanic White",Female,Utah,49,14559,3154,17713,0.8219386891
"Non-Hispanic White",Female,Vermont,50,11873,1608,13481,0.8807210148
"Non-Hispanic White",Female,Virginia,51,85027,14292,99319,0.8561000413
"Non-Hispanic White",Female,Washington,53,60713,10197,70910,0.8561979975
"Non-Hispanic White",Female,"West Virginia",54,36283,6883,43166,0.8405457999
"Non-Hispanic White",Female,Wisconsin,55,73428,8388,81816,0.8974772661
"Non-Hispanic White",Female,Wyoming,56,7468,1386,8854,0.8434605828
"Black or African-American",Male,Alabama,1,10336,3896,14232,0.7262507026
"Black or African-American",Male,Alaska,2,132,40,172,0.7674418605
"Black or African-American",Male,Arizona,4,1459,477,1936,0.7536157025
"Black or African-American",Male,Arkansas,5,4111,1815,5926,0.6937225785
"Black or African-American",Male,California,6,12029,4267,16296,0.7381566028
"Black or African-American",Male,Colorado,8,878,326,1204,0.7292358804
"Black or African-American",Male,Connecticut,9,2877,797,3674,0.7830702232
"Black or African-American",Male,Delaware,10,2139,625,2764,0.773878437
"Black or African-American",Male,"District of Columbia",11,2044,800,2844,0.7187060478
"Black or African-American",Male,Florida,12,16351,6178,22529,0.7257756669
"Black or African-American",Male,Georgia,13,17557,6913,24470,0.7174908051
"Black or African-American",Male,Hawaii,15,74,31,105,0.7047619048
"Black or African-American",Male,Idaho,16,56,21,77,0.7272727273
"Black or African-American",Male,Illinois,17,15084,5151,20235,0.7454410675
"Black or African-American",Male,Indiana,18,5328,1716,7044,0.7563884157
"Black or African-American",Male,Iowa,19,844,235,1079,0.7822057461
"Black or African-American",Male,Kansas,20,1372,458,1830,0.749726776
"Black or African-American",Male,Kentucky,21,3188,1200,4388,0.7265268915
"Black or African-American",Male,Louisiana,22,11483,4862,16345,0.7025390028
"Black or African-American",Male,Maine,23,110,27,137,0.802919708
"Black or African-American",Male,Maryland,24,12276,3837,16113,0.7618692981
"Black or African-American",Male,Massachusetts,25,4031,1081,5112,0.7885367762
"Black or African-American",Male,Michigan,26,13741,4749,18490,0.743158464
"Black or African-American",Male,Minnesota,27,1713,563,2276,0.7526362039
"Black or African-American",Male,Mississippi,28,11076,4778,15854,0.6986249527
"Black or African-American",Male,Missouri,29,5269,1958,7227,0.7290715373
"Black or African-American",Male,Montana,30,35,12,47,0.7446808511
"Black or African-American",Male,Nebraska,31,590,198,788,0.7487309645
"Black or African-American",Male,Nevada,32,1443,601,2044,0.7059686888
"Black or African-American",Male,"New Hampshire",33,120,36,156,0.7692307692
"Black or African-American",Male,"New Jersey",34,9417,2940,12357,0.7620781743
"Black or African-American",Male,"New Mexico",35,262,113,375,0.6986666667
"Black or African-American",Male,"New York",36,16965,5625,22590,0.7509960159
"Black or African-American",Male,"North Carolina",37,19502,6953,26455,0.7371763372
"Black or African-American",Male,"North Dakota",38,37,19,56,0.6607142857
"Black or African-American",Male,Ohio,39,11641,3840,15481,0.7519540081
"Black or African-American",Male,Oklahoma,40,2150,886,3036,0.708168643
"Black or African-American",Male,Oregon,41,440,134,574,0.7665505226
"Black or African-American",Male,Pennsylvania,42,9144,3084,12228,0.7477919529
"Black or African-American",Male,"Rhode Island",44,433,110,543,0.7974217311
"Black or African-American",Male,"South Carolina",45,11171,4333,15504,0.7205237358
"Black or African-American",Male,"South Dakota",46,49,22,71,0.6901408451
"Black or African-American",Male,Tennessee,47,7181,2851,10032,0.7158094099
"Black or African-American",Male,Texas,48,18057,7472,25529,0.7073132516
"Black or African-American",Male,Utah,49,73,46,119,0.6134453782
"Black or African-American",Male,Vermont,50,46,12,58,0.7931034483
"Black or African-American",Male,Virginia,51,12646,3852,16498,0.7665171536
"Black or African-American",Male,Washington,53,1472,522,1994,0.7382146439
"Black or African-American",Male,"West Virginia",54,723,232,955,0.7570680628
"Black or African-American",Male,Wisconsin,55,2614,737,3351,0.780065652
"Black or African-American",Male,Wyoming,56,.,.,.,0.8039215686
"Black or African-American",Female,Alabama,1,19229,6119,25348,0.758600284
"Black or African-American",Female,Alaska,2,208,51,259,0.8030888031
"Black or African-American",Female,Arizona,4,2065,715,2780,0.7428057554
"Black or African-American",Female,Arkansas,5,7044,2711,9755,0.7220912353
"Black or African-American",Female,California,6,18421,5769,24190,0.7615130219
"Black or African-American",Female,Colorado,8,1129,344,1473,0.7664630007
"Black or African-American",Female,Connecticut,9,4518,1041,5559,0.8127361036
"Black or African-American",Female,Delaware,10,3631,946,4577,0.7933143981
"Black or African-American",Female,"District of Columbia",11,3366,1085,4451,0.756234554
"Black or African-American",Female,Florida,12,26326,8829,35155,0.7488550704
"Black or African-American",Female,Georgia,13,31170,10482,41652,0.7483434169
"Black or African-American",Female,Hawaii,15,70,19,89,0.7865168539
"Black or African-American",Female,Idaho,16,46,16,62,0.7419354839
"Black or African-American",Female,Illinois,17,26684,7880,34564,0.7720171276
"Black or African-American",Female,Indiana,18,8995,2608,11603,0.7752305438
"Black or African-American",Female,Iowa,19,1090,279,1369,0.796201607
"Black or African-American",Female,Kansas,20,2063,557,2620,0.7874045802
"Black or African-American",Female,Kentucky,21,5062,1695,6757,0.7491490306
"Black or African-American",Female,Louisiana,22,20480,7509,27989,0.7317160313
"Black or African-American",Female,Maine,23,82,21,103,0.7961165049
"Black or African-American",Female,Maryland,24,21642,6053,27695,0.7814406933
"Black or African-American",Female,Massachusetts,25,5589,1282,6871,0.8134187163
"Black or African-American",Female,Michigan,26,23033,7132,30165,0.7635670479
"Black or African-American",Female,Minnesota,27,1930,639,2569,0.7512650837
"Black or African-American",Female,Mississippi,28,19877,6988,26865,0.7398846082
"Black or African-American",Female,Missouri,29,8687,2659,11346,0.7656442799
"Black or African-American",Female,Montana,30,.,.,.,0.7428571429
"Black or African-American",Female,Nebraska,31,883,256,1139,0.7752414399
"Black or African-American",Female,Nevada,32,2349,873,3222,0.7290502793
"Black or African-American",Female,"New Hampshire",33,161,40,201,0.8009950249
"Black or African-American",Female,"New Jersey",34,16484,4623,21107,0.7809731369
"Black or African-American",Female,"New Mexico",35,368,130,498,0.7389558233
"Black or African-American",Female,"New York",36,28999,8604,37603,0.771188469
"Black or African-American",Female,"North Carolina",37,34417,9968,44385,0.7754196237
"Black or African-American",Female,"North Dakota",38,42,15,57,0.7368421053
"Black or African-American",Female,Ohio,39,18294,5265,23559,0.776518528
"Black or African-American",Female,Oklahoma,40,3827,1291,5118,0.7477530285
"Black or African-American",Female,Oregon,41,477,143,620,0.7693548387
"Black or African-American",Female,Pennsylvania,42,13627,3880,17507,0.7783743645
"Black or African-American",Female,"Rhode Island",44,544,131,675,0.8059259259
"Black or African-American",Female,"South Carolina",45,20334,6415,26749,0.7601779506
"Black or African-American",Female,"South Dakota",46,47,14,61,0.7704918033
"Black or African-American",Female,Tennessee,47,13176,4221,17397,0.7573719607
"Black or African-American",Female,Texas,48,33399,12116,45515,0.7338020433
"Black or African-American",Female,Utah,49,113,31,144,0.7847222222
"Black or African-American",Female,Vermont,50,.,.,.,0.8
"Black or African-American",Female,Virginia,51,21812,5989,27801,0.7845760944
"Black or African-American",Female,Washington,53,1826,510,2336,0.7816780822
"Black or African-American",Female,"West Virginia",54,1027,299,1326,0.7745098039
"Black or African-American",Female,Wisconsin,55,3767,1018,4785,0.7872518286
"Black or African-American",Female,Wyoming,56,40,12,52,0.7692307692
Other,Male,Alabama,1,163,38,201,0.8109452736
Other,Male,Alaska,2,68,25,93,0.7311827957
Other,Male,Arizona,4,456,85,541,0.842883549
Other,Male,Arkansas,5,143,34,177,0.8079096045
Other,Male,California,6,4806,938,5744,0.8366991643
Other,Male,Colorado,8,223,48,271,0.8228782288000001
Other,Male,Connecticut,9,450,69,519,0.8670520231
Other,Male,Delaware,10,154,16,170,0.9058823529
Other,Male,"District of Columbia",11,.,.,.,0.7567567568
Other,Male,Florida,12,1845,363,2208,0.8355978261
Other,Male,Georgia,13,459,103,562,0.8167259786
Other,Male,Hawaii,15,1196,202,1398,0.8555078684
Other,Male,Idaho,16,103,19,122,0.8442622951
Other,Male,Illinois,17,1613,268,1881,0.8575225944
Other,Male,Indiana,18,444,67,511,0.8688845401
Other,Male,Iowa,19,206,29,235,0.8765957447
Other,Male,Kansas,20,200,31,231,0.8658008658
Other,Male,Kentucky,21,247,46,293,0.843003413
Other,Male,Louisiana,22,243,43,286,0.8496503497
Other,Male,Maine,23,137,18,155,0.8838709677
Other,Male,Maryland,24,650,106,756,0.8597883598
Other,Male,Massachusetts,25,1183,179,1362,0.8685756241
Other,Male,Michigan,26,1206,213,1419,0.8498942918
Other,Male,Minnesota,27,440,73,513,0.8576998051
Other,Male,Mississippi,28,73,19,92,0.7934782609
Other,Male,Missouri,29,348,60,408,0.8529411765
Other,Male,Montana,30,.,.,.,0.875
Other,Male,Nebraska,31,121,21,142,0.8521126761
Other,Male,Nevada,32,359,80,439,0.8177676538
Other,Male,"New Hampshire",33,151,26,177,0.8531073446
Other,Male,"New Jersey",34,1427,295,1722,0.8286875726
Other,Male,"New Mexico",35,92,25,117,0.7863247863
Other,Male,"New York",36,3117,656,3773,0.8261330506
Other,Male,"North Carolina",37,890,216,1106,0.8047016275
Other,Male,"North Dakota",38,.,.,.,0.8636363636
Other,Male,Ohio,39,862,151,1013,0.8509378085
Other,Male,Oklahoma,40,222,57,279,0.7956989247
Other,Male,Oregon,41,275,52,327,0.8409785933
Other,Male,Pennsylvania,42,922,152,1074,0.8584729981
Other,Male,"Rhode Island",44,132,34,166,0.7951807229
Other,Male,"South Carolina",45,257,41,298,0.8624161074
Other,Male,"South Dakota",46,.,.,.,0.8630136986
Other,Male,Tennessee,47,279,76,355,0.785915493
Other,Male,Texas,48,1332,312,1644,0.8102189781
Other,Male,Utah,49,99,20,119,0.8319327731
Other,Male,Vermont,50,81,11,92,0.8804347826
Other,Male,Virginia,51,681,135,816,0.8345588235
Other,Male,Washington,53,649,111,760,0.8539473684
Other,Male,"West Virginia",54,110,30,140,0.7857142857
Other,Male,Wisconsin,55,371,53,424,0.875
Other,Male,Wyoming,56,.,.,.,0.9032258065
Other,Female,Alabama,1,143,28,171,0.8362573099
Other,Female,Alaska,2,78,13,91,0.8571428571
Other,Female,Arizona,4,393,83,476,0.8256302521
Other,Female,Arkansas,5,101,25,126,0.8015873016
Other,Female,California,6,4800,841,5641,0.8509129587
Other,Female,Colorado,8,177,40,217,0.8156682028
Other,Female,Connecticut,9,373,59,432,0.8634259259
Other,Female,Delaware,10,91,18,109,0.8348623853
Other,Female,"District of Columbia",11,.,.,.,0.9473684211
Other,Female,Florida,12,1457,287,1744,0.8354357798
Other,Female,Georgia,13,383,95,478,0.8012552301
Other,Female,Hawaii,15,1157,174,1331,0.8692712246
Other,Female,Idaho,16,79,11,90,0.8777777778
Other,Female,Illinois,17,1300,226,1526,0.8519003932
Other,Female,Indiana,18,331,45,376,0.8803191489
Other,Female,Iowa,19,154,16,170,0.9058823529
Other,Female,Kansas,20,139,28,167,0.8323353293
Other,Female,Kentucky,21,141,30,171,0.8245614035
Other,Female,Louisiana,22,197,37,234,0.8418803419
Other,Female,Maine,23,76,19,95,0.8
Other,Female,Maryland,24,550,96,646,0.8513931889
Other,Female,Massachusetts,25,1036,174,1210,0.8561983471
Other,Female,Michigan,26,895,154,1049,0.8531935176
Other,Female,Minnesota,27,269,39,308,0.8733766234
Other,Female,Mississippi,28,99,17,116,0.8534482759
Other,Female,Missouri,29,230,42,272,0.8455882353
Other,Female,Montana,30,.,.,.,0.9538461538
Other,Female,Nebraska,31,88,11,99,0.8888888889
Other,Female,Nevada,32,320,86,406,0.7881773399
Other,Female,"New Hampshire",33,80,19,99,0.8080808081
Other,Female,"New Jersey",34,1282,212,1494,0.8580990629
Other,Female,"New Mexico",35,89,22,111,0.8018018018
Other,Female,"New York",36,3157,620,3777,0.8358485571
Other,Female,"North Carolina",37,862,163,1025,0.8409756098
Other,Female,"North Dakota",38,.,.,.,0.8780487805
Other,Female,Ohio,39,693,140,833,0.8319327731
Other,Female,Oklahoma,40,160,38,198,0.8080808081
Other,Female,Oregon,41,260,46,306,0.8496732026
Other,Female,Pennsylvania,42,690,117,807,0.8550185874
Other,Female,"Rhode Island",44,128,25,153,0.8366013072
Other,Female,"South Carolina",45,185,46,231,0.8008658009
Other,Female,"South Dakota",46,37,11,48,0.7708333333
Other,Female,Tennessee,47,201,59,260,0.7730769231
Other,Female,Texas,48,1156,243,1399,0.8263045032
Other,Female,Utah,49,83,17,100,0.83
Other,Female,Vermont,50,.,.,.,0.8615384615
Other,Female,Virginia,51,514,78,592,0.8682432432
Other,Female,Washington,53,649,133,782,0.8299232737
Other,Female,"West Virginia",54,72,12,84,0.8571428571
Other,Female,Wisconsin,55,253,33,286,0.8846153846
Other,Female,Wyoming,56,.,.,.,0.8148148148
"Asian/Pacific Islander",Male,Alabama,1,216,47,263,0.8212927757
"Asian/Pacific Islander",Male,Alaska,2,281,65,346,0.8121387283
"Asian/Pacific Islander",Male,Arizona,4,818,202,1020,0.8019607843
"Asian/Pacific Islander",Male,Arkansas,5,187,63,250,0.748
"Asian/Pacific Islander",Male,California,6,34588,6703,41291,0.8376643821
"Asian/Pacific Islander",Male,Colorado,8,460,84,544,0.8455882353
"Asian/Pacific Islander",Male,Connecticut,9,791,134,925,0.8551351351
"Asian/Pacific Islander",Male,Delaware,10,240,37,277,0.8664259928
"Asian/Pacific Islander",Male,"District of Columbia",11,79,12,91,0.8681318681
"Asian/Pacific Islander",Male,Florida,12,3016,609,3625,0.832
"Asian/Pacific Islander",Male,Georgia,13,1576,342,1918,0.8216892596
"Asian/Pacific Islander",Male,Hawaii,15,4441,871,5312,0.8360316265
"Asian/Pacific Islander",Male,Idaho,16,99,17,116,0.8534482759
"Asian/Pacific Islander",Male,Illinois,17,4869,821,5690,0.855711775
"Asian/Pacific Islander",Male,Indiana,18,545,116,661,0.8245083207
"Asian/Pacific Islander",Male,Iowa,19,255,48,303,0.8415841584
"Asian/Pacific Islander",Male,Kansas,20,261,64,325,0.8030769231
"Asian/Pacific Islander",Male,Kentucky,21,210,68,278,0.7553956835
"Asian/Pacific Islander",Male,Louisiana,22,406,81,487,0.8336755647
"Asian/Pacific Islander",Male,Maine,23,88,17,105,0.8380952381
"Asian/Pacific Islander",Male,Maryland,24,2505,447,2952,0.8485772358
"Asian/Pacific Islander",Male,Massachusetts,25,2477,417,2894,0.8559087768
"Asian/Pacific Islander",Male,Michigan,26,1723,365,2088,0.8251915709
"Asian/Pacific Islander",Male,Minnesota,27,832,186,1018,0.8172888016
"Asian/Pacific Islander",Male,Mississippi,28,159,40,199,0.7989949749
"Asian/Pacific Islander",Male,Missouri,29,480,113,593,0.8094435076
"Asian/Pacific Islander",Male,Montana,30,.,.,.,0.9111111111
"Asian/Pacific Islander",Male,Nebraska,31,161,27,188,0.8563829787
"Asian/Pacific Islander",Male,Nevada,32,1132,310,1442,0.7850208044
"Asian/Pacific Islander",Male,"New Hampshire",33,120,18,138,0.8695652174
"Asian/Pacific Islander",Male,"New Jersey",34,5415,939,6354,0.8522190746
"Asian/Pacific Islander",Male,"New Mexico",35,136,33,169,0.8047337278
"Asian/Pacific Islander",Male,"New York",36,9520,1637,11157,0.8532759702
"Asian/Pacific Islander",Male,"North Carolina",37,1053,247,1300,0.81
"Asian/Pacific Islander",Male,"North Dakota",38,.,.,.,0.8571428571
"Asian/Pacific Islander",Male,Ohio,39,1268,269,1537,0.8249837345
"Asian/Pacific Islander",Male,Oklahoma,40,341,81,422,0.808056872
"Asian/Pacific Islander",Male,Oregon,41,608,117,725,0.8386206897
"Asian/Pacific Islander",Male,Pennsylvania,42,2337,416,2753,0.8488921177
"Asian/Pacific Islander",Male,"Rhode Island",44,159,20,179,0.8882681564
"Asian/Pacific Islander",Male,"South Carolina",45,358,85,443,0.8081264108
"Asian/Pacific Islander",Male,"South Dakota",46,.,.,.,0.8157894737
"Asian/Pacific Islander",Male,Tennessee,47,447,97,544,0.8216911765
"Asian/Pacific Islander",Male,Texas,48,6449,1370,7819,0.8247857782
"Asian/Pacific Islander",Male,Utah,49,219,75,294,0.7448979592
"Asian/Pacific Islander",Male,Vermont,50,.,.,.,0.9230769231
"Asian/Pacific Islander",Male,Virginia,51,2535,492,3027,0.8374628345
"Asian/Pacific Islander",Male,Washington,53,2981,592,3573,0.8343129023
"Asian/Pacific Islander",Male,"West Virginia",54,87,16,103,0.8446601942
"Asian/Pacific Islander",Male,Wisconsin,55,573,170,743,0.7711978466
"Asian/Pacific Islander",Male,Wyoming,56,.,.,.,0.88
"Asian/Pacific Islander",Female,Alabama,1,266,53,319,0.8338557994
"Asian/Pacific Islander",Female,Alaska,2,308,73,381,0.8083989501
"Asian/Pacific Islander",Female,Arizona,4,1033,194,1227,0.8418907905
"Asian/Pacific Islander",Female,Arkansas,5,199,62,261,0.7624521073
"Asian/Pacific Islander",Female,California,6,44638,7914,52552,0.8494063023
"Asian/Pacific Islander",Female,Colorado,8,451,92,543,0.8305709024
"Asian/Pacific Islander",Female,Connecticut,9,810,152,962,0.841995842
"Asian/Pacific Islander",Female,Delaware,10,264,25,289,0.9134948097
"Asian/Pacific Islander",Female,"District of Columbia",11,75,15,90,0.8333333333
"Asian/Pacific Islander",Female,Florida,12,3313,698,4011,0.825978559
"Asian/Pacific Islander",Female,Georgia,13,1528,321,1849,0.8263926447
"Asian/Pacific Islander",Female,Hawaii,15,5164,857,6021,0.8576648397
"Asian/Pacific Islander",Female,Idaho,16,139,35,174,0.7988505747
"Asian/Pacific Islander",Female,Illinois,17,4998,797,5795,0.8624676445
"Asian/Pacific Islander",Female,Indiana,18,592,133,725,0.8165517241
"Asian/Pacific Islander",Female,Iowa,19,375,67,442,0.8484162896
"Asian/Pacific Islander",Female,Kansas,20,314,60,374,0.8395721925
"Asian/Pacific Islander",Female,Kentucky,21,270,69,339,0.796460177
"Asian/Pacific Islander",Female,Louisiana,22,467,105,572,0.8164335664
"Asian/Pacific Islander",Female,Maine,23,94,16,110,0.8545454545
"Asian/Pacific Islander",Female,Maryland,24,2988,496,3484,0.8576349024
"Asian/Pacific Islander",Female,Massachusetts,25,2904,382,3286,0.8837492392
"Asian/Pacific Islander",Female,Michigan,26,1956,377,2333,0.8384054865
"Asian/Pacific Islander",Female,Minnesota,27,834,181,1015,0.8216748768
"Asian/Pacific Islander",Female,Mississippi,28,152,54,206,0.7378640777
"Asian/Pacific Islander",Female,Missouri,29,555,124,679,0.8173784978
"Asian/Pacific Islander",Female,Montana,30,.,.,.,0.8970588235
"Asian/Pacific Islander",Female,Nebraska,31,188,36,224,0.8392857143
"Asian/Pacific Islander",Female,Nevada,32,1588,366,1954,0.812691914
"Asian/Pacific Islander",Female,"New Hampshire",33,128,24,152,0.8421052632
"Asian/Pacific Islander",Female,"New Jersey",34,5660,964,6624,0.854468599
"Asian/Pacific Islander",Female,"New Mexico",35,128,24,152,0.8421052632
"Asian/Pacific Islander",Female,"New York",36,12180,1896,14076,0.8653026428
"Asian/Pacific Islander",Female,"North Carolina",37,1181,240,1421,0.8311048557
"Asian/Pacific Islander",Female,"North Dakota",38,.,.,.,0.8571428571
"Asian/Pacific Islander",Female,Ohio,39,1245,233,1478,0.8423545332
"Asian/Pacific Islander",Female,Oklahoma,40,446,94,540,0.8259259259
"Asian/Pacific Islander",Female,Oregon,41,833,147,980,0.85
"Asian/Pacific Islander",Female,Pennsylvania,42,2504,402,2906,0.8616655196
"Asian/Pacific Islander",Female,"Rhode Island",44,166,24,190,0.8736842105
"Asian/Pacific Islander",Female,"South Carolina",45,329,86,415,0.7927710843
"Asian/Pacific Islander",Female,"South Dakota",46,.,.,.,0.8831168831
"Asian/Pacific Islander",Female,Tennessee,47,472,113,585,0.8068376068
"Asian/Pacific Islander",Female,Texas,48,7283,1381,8664,0.8406048015
"Asian/Pacific Islander",Female,Utah,49,256,62,318,0.8050314465
"Asian/Pacific Islander",Female,Vermont,50,.,.,.,0.8571428571
"Asian/Pacific Islander",Female,Virginia,51,2702,451,3153,0.8569616239
"Asian/Pacific Islander",Female,Washington,53,3942,670,4612,0.8547267997
"Asian/Pacific Islander",Female,"West Virginia",54,89,23,112,0.7946428571
"Asian/Pacific Islander",Female,Wisconsin,55,618,141,759,0.814229249
"Asian/Pacific Islander",Female,Wyoming,56,.,.,.,0.7916666667
Hispanic,Male,Alabama,1,297,84,381,0.7795275591
Hispanic,Male,Alaska,2,156,29,185,0.8432432432
Hispanic,Male,Arizona,4,5666,1783,7449,0.7606390119
Hispanic,Male,Arkansas,5,429,169,598,0.7173913043
Hispanic,Male,California,6,47731,14070,61801,0.772333781
Hispanic,Male,Colorado,8,2991,859,3850,0.7768831169
Hispanic,Male,Connecticut,9,2763,686,3449,0.8011017686
Hispanic,Male,Delaware,10,355,90,445,0.797752809
Hispanic,Male,"District of Columbia",11,134,39,173,0.774566474
Hispanic,Male,Florida,12,24048,5441,29489,0.8154905219
Hispanic,Male,Georgia,13,1417,462,1879,0.7541245343
Hispanic,Male,Hawaii,15,603,159,762,0.7913385827
Hispanic,Male,Idaho,16,533,166,699,0.7625178827
Hispanic,Male,Illinois,17,8761,2293,11054,0.7925637778
Hispanic,Male,Indiana,18,1474,365,1839,0.8015225666
Hispanic,Male,Iowa,19,447,91,538,0.8308550186
Hispanic,Male,Kansas,20,947,292,1239,0.7643260694
Hispanic,Male,Kentucky,21,271,93,364,0.7445054945
Hispanic,Male,Louisiana,22,940,243,1183,0.7945900254
Hispanic,Male,Maine,23,87,22,109,0.7981651376
Hispanic,Male,Maryland,24,1298,354,1652,0.7857142857
Hispanic,Male,Massachusetts,25,5945,1296,7241,0.8210191962
Hispanic,Male,Michigan,26,2319,538,2857,0.8116905845
Hispanic,Male,Minnesota,27,619,141,760,0.8144736842
Hispanic,Male,Mississippi,28,187,62,249,0.7510040161
Hispanic,Male,Missouri,29,708,187,895,0.7910614525
Hispanic,Male,Montana,30,135,41,176,0.7670454545
Hispanic,Male,Nebraska,31,517,153,670,0.771641791
Hispanic,Male,Nevada,32,1979,666,2645,0.7482041588
Hispanic,Male,"New Hampshire",33,216,49,265,0.8150943396
Hispanic,Male,"New Jersey",34,9132,2404,11536,0.7916088766
Hispanic,Male,"New Mexico",35,5049,1564,6613,0.763496144
Hispanic,Male,"New York",36,14187,3752,17939,0.7908467585
Hispanic,Male,"North Carolina",37,1393,400,1793,0.7769102064
Hispanic,Male,"North Dakota",38,55,16,71,0.7746478873
Hispanic,Male,Ohio,39,1911,463,2374,0.8049705139
Hispanic,Male,Oklahoma,40,909,312,1221,0.7444717445
Hispanic,Male,Oregon,41,1118,342,1460,0.7657534247
Hispanic,Male,Pennsylvania,42,3876,989,4865,0.7967112025
Hispanic,Male,"Rhode Island",44,955,171,1126,0.8481349911
Hispanic,Male,"South Carolina",45,531,135,666,0.7972972973
Hispanic,Male,"South Dakota",46,81,24,105,0.7714285714
Hispanic,Male,Tennessee,47,541,161,702,0.7706552707
Hispanic,Male,Texas,48,37609,12470,50079,0.7509934304
Hispanic,Male,Utah,49,578,195,773,0.7477360931
Hispanic,Male,Vermont,50,.,.,.,0.8611111111
Hispanic,Male,Virginia,51,1268,355,1623,0.7812692545
Hispanic,Male,Washington,53,2093,595,2688,0.7786458333
Hispanic,Male,"West Virginia",54,115,23,138,0.8333333333
Hispanic,Male,Wisconsin,55,1113,292,1405,0.7921708185
Hispanic,Male,Wyoming,56,233,67,300,0.7766666667
Hispanic,Female,Alabama,1,431,130,561,0.7682709447
Hispanic,Female,Alaska,2,171,45,216,0.7916666667
Hispanic,Female,Arizona,4,6269,1743,8012,0.782451323
Hispanic,Female,Arkansas,5,586,198,784,0.7474489796
Hispanic,Female,California,6,60268,15501,75769,0.795417651
Hispanic,Female,Colorado,8,3479,941,4420,0.7871040724
Hispanic,Female,Connecticut,9,3397,715,4112,0.826118677
Hispanic,Female,Delaware,10,448,94,542,0.8265682657
Hispanic,Female,"District of Columbia",11,227,51,278,0.8165467626
Hispanic,Female,Florida,12,36669,7451,44120,0.8311196736
Hispanic,Female,Georgia,13,1905,578,2483,0.7672170761
Hispanic,Female,Hawaii,15,721,139,860,0.838372093
Hispanic,Female,Idaho,16,624,175,799,0.7809762203
Hispanic,Female,Illinois,17,10852,2428,13280,0.8171686747
Hispanic,Female,Indiana,18,1891,462,2353,0.8036549086
Hispanic,Female,Iowa,19,616,161,777,0.7927927928
Hispanic,Female,Kansas,20,1254,325,1579,0.7941735275
Hispanic,Female,Kentucky,21,429,145,574,0.7473867596
Hispanic,Female,Louisiana,22,1263,331,1594,0.7923462986
Hispanic,Female,Maine,23,122,33,155,0.7870967742
Hispanic,Female,Maryland,24,2113,458,2571,0.8218591988
Hispanic,Female,Massachusetts,25,7437,1413,8850,0.8403389831
Hispanic,Female,Michigan,26,2776,669,3445,0.8058055152
Hispanic,Female,Minnesota,27,699,160,859,0.8137369034
Hispanic,Female,Mississippi,28,284,105,389,0.7300771208
Hispanic,Female,Missouri,29,899,235,1134,0.7927689594
Hispanic,Female,Montana,30,157,34,191,0.8219895288
Hispanic,Female,Nebraska,31,632,158,790,0.8
Hispanic,Female,Nevada,32,2669,841,3510,0.7603988604
Hispanic,Female,"New Hampshire",33,258,53,311,0.8295819936
Hispanic,Female,"New Jersey",34,13242,2963,16205,0.817155199
Hispanic,Female,"New Mexico",35,5694,1522,7216,0.7890798226
Hispanic,Female,"New York",36,22303,5109,27412,0.8136217715
Hispanic,Female,"North Carolina",37,2229,539,2768,0.8052745665
Hispanic,Female,"North Dakota",38,73,15,88,0.8295454545
Hispanic,Female,Ohio,39,2264,545,2809,0.8059807761
Hispanic,Female,Oklahoma,40,1181,422,1603,0.7367436057
Hispanic,Female,Oregon,41,1359,358,1717,0.7914967967
Hispanic,Female,Pennsylvania,42,4546,1095,5641,0.8058854813
Hispanic,Female,"Rhode Island",44,1178,234,1412,0.8342776204
Hispanic,Female,"South Carolina",45,767,199,966,0.7939958592
Hispanic,Female,"South Dakota",46,91,16,107,0.8504672897
Hispanic,Female,Tennessee,47,758,223,981,0.7726809378
Hispanic,Female,Texas,48,49659,14640,64299,0.7723137218
Hispanic,Female,Utah,49,649,224,873,0.7434135166
Hispanic,Female,Vermont,50,62,15,77,0.8051948052
Hispanic,Female,Virginia,51,1889,427,2316,0.8156303972
Hispanic,Female,Washington,53,2768,673,3441,0.8044173205
Hispanic,Female,"West Virginia",54,152,37,189,0.8042328042
Hispanic,Female,Wisconsin,55,1452,298,1750,0.8297142857
Hispanic,Female,Wyoming,56,300,82,382,0.7853403141
"American Indian / Alaska Native",Male,Alabama,1,46,22,68,0.6764705882
"American Indian / Alaska Native",Male,Alaska,2,586,212,798,0.7343358396
"American Indian / Alaska Native",Male,Arizona,4,808,581,1389,0.5817134629
"American Indian / Alaska Native",Male,Arkansas,5,131,39,170,0.7705882353
"American Indian / Alaska Native",Male,California,6,772,251,1023,0.7546432063
"American Indian / Alaska Native",Male,Colorado,8,88,24,112,0.7857142857
"American Indian / Alaska Native",Male,Connecticut,9,.,.,.,0.8148148148
"American Indian / Alaska Native",Male,Delaware,10,.,.,.,0.75
"American Indian / Alaska Native",Male,"District of Columbia",11,0,.,.,0
"American Indian / Alaska Native",Male,Florida,12,126,26,152,0.8289473684
"American Indian / Alaska Native",Male,Georgia,13,32,12,44,0.7272727273
"American Indian / Alaska Native",Male,Hawaii,15,.,.,.,0.8333333333
"American Indian / Alaska Native",Male,Idaho,16,77,34,111,0.6936936937
"American Indian / Alaska Native",Male,Illinois,17,60,13,73,0.8219178082
"American Indian / Alaska Native",Male,Indiana,18,28,14,42,0.6666666667
"American Indian / Alaska Native",Male,Iowa,19,43,18,61,0.7049180328
"American Indian / Alaska Native",Male,Kansas,20,127,45,172,0.738372093
"American Indian / Alaska Native",Male,Kentucky,21,.,.,.,0.8181818182
"American Indian / Alaska Native",Male,Louisiana,22,52,16,68,0.7647058824
"American Indian / Alaska Native",Male,Maine,23,61,19,80,0.7625
"American Indian / Alaska Native",Male,Maryland,24,.,.,.,0.8285714286
"American Indian / Alaska Native",Male,Massachusetts,25,43,13,56,0.7678571429
"American Indian / Alaska Native",Male,Michigan,26,378,91,469,0.8059701493
"American Indian / Alaska Native",Male,Minnesota,27,367,133,500,0.734
"American Indian / Alaska Native",Male,Mississippi,28,34,25,59,0.5762711864
"American Indian / Alaska Native",Male,Missouri,29,82,33,115,0.7130434783
"American Indian / Alaska Native",Male,Montana,30,252,151,403,0.6253101737
"American Indian / Alaska Native",Male,Nebraska,31,69,33,102,0.6764705882
"American Indian / Alaska Native",Male,Nevada,32,71,36,107,0.6635514019
"American Indian / Alaska Native",Male,"New Hampshire",33,.,.,.,0.875
"American Indian / Alaska Native",Male,"New Jersey",34,42,18,60,0.7
"American Indian / Alaska Native",Male,"New Mexico",35,492,297,789,0.6235741445
"American Indian / Alaska Native",Male,"New York",36,261,73,334,0.7814371257
"American Indian / Alaska Native",Male,"North Carolina",37,547,188,735,0.7442176871
"American Indian / Alaska Native",Male,"North Dakota",38,190,87,277,0.6859205776
"American Indian / Alaska Native",Male,Ohio,39,.,.,.,0.8181818182
"American Indian / Alaska Native",Male,Oklahoma,40,2388,1168,3556,0.6715410574
"American Indian / Alaska Native",Male,Oregon,41,219,79,298,0.7348993289
"American Indian / Alaska Native",Male,Pennsylvania,42,.,.,.,0.8409090909
"American Indian / Alaska Native",Male,"Rhode Island",44,.,.,.,0.8695652174
"American Indian / Alaska Native",Male,"South Carolina",45,43,20,63,0.6825396825
"American Indian / Alaska Native",Male,"South Dakota",46,182,167,349,0.5214899713
"American Indian / Alaska Native",Male,Tennessee,47,33,13,46,0.7173913043
"American Indian / Alaska Native",Male,Texas,48,307,101,408,0.7524509804
"American Indian / Alaska Native",Male,Utah,49,68,37,105,0.6476190476
"American Indian / Alaska Native",Male,Vermont,50,.,0,.,1
"American Indian / Alaska Native",Male,Virginia,51,.,.,.,0.7368421053
"American Indian / Alaska Native",Male,Washington,53,550,195,745,0.7382550336
"American Indian / Alaska Native",Male,"West Virginia",54,.,.,.,0.8181818182
"American Indian / Alaska Native",Male,Wisconsin,55,370,98,468,0.7905982906
"American Indian / Alaska Native",Male,Wyoming,56,51,24,75,0.68
"American Indian / Alaska Native",Female,Alabama,1,62,19,81,0.7654320988
"American Indian / Alaska Native",Female,Alaska,2,708,236,944,0.75
"American Indian / Alaska Native",Female,Arizona,4,805,703,1508,0.5338196286
"American Indian / Alaska Native",Female,Arkansas,5,163,57,220,0.7409090909
"American Indian / Alaska Native",Female,California,6,1131,339,1470,0.7693877551
"American Indian / Alaska Native",Female,Colorado,8,104,31,135,0.7703703704
"American Indian / Alaska Native",Female,Connecticut,9,.,.,.,0.8181818182
"American Indian / Alaska Native",Female,Delaware,10,.,.,.,0.8888888889
"American Indian / Alaska Native",Female,"District of Columbia",11,.,0,.,1
"American Indian / Alaska Native",Female,Florida,12,162,43,205,0.7902439024
"American Indian / Alaska Native",Female,Georgia,13,50,14,64,0.78125
"American Indian / Alaska Native",Female,Hawaii,15,.,.,.,0.9333333333
"American Indian / Alaska Native",Female,Idaho,16,88,49,137,0.6423357664
"American Indian / Alaska Native",Female,Illinois,17,76,23,99,0.7676767677
"American Indian / Alaska Native",Female,Indiana,18,51,13,64,0.796875
"American Indian / Alaska Native",Female,Iowa,19,62,27,89,0.6966292135
"American Indian / Alaska Native",Female,Kansas,20,183,60,243,0.7530864198
"American Indian / Alaska Native",Female,Kentucky,21,.,.,.,0.7352941176
"American Indian / Alaska Native",Female,Louisiana,22,62,12,74,0.8378378378
"American Indian / Alaska Native",Female,Maine,23,58,19,77,0.7532467532
"American Indian / Alaska Native",Female,Maryland,24,.,.,.,0.8148148148
"American Indian / Alaska Native",Female,Massachusetts,25,.,.,.,0.8846153846
"American Indian / Alaska Native",Female,Michigan,26,483,90,573,0.8429319372
"American Indian / Alaska Native",Female,Minnesota,27,528,162,690,0.7652173913
"American Indian / Alaska Native",Female,Mississippi,28,40,26,66,0.6060606061
"American Indian / Alaska Native",Female,Missouri,29,145,40,185,0.7837837838
"American Indian / Alaska Native",Female,Montana,30,371,164,535,0.6934579439
"American Indian / Alaska Native",Female,Nebraska,31,124,63,187,0.6631016043
"American Indian / Alaska Native",Female,Nevada,32,109,60,169,0.6449704142
"American Indian / Alaska Native",Female,"New Hampshire",33,.,0,.,1
"American Indian / Alaska Native",Female,"New Jersey",34,45,11,56,0.8035714286
"American Indian / Alaska Native",Female,"New Mexico",35,464,311,775,0.5987096774
"American Indian / Alaska Native",Female,"New York",36,386,90,476,0.8109243697
"American Indian / Alaska Native",Female,"North Carolina",37,716,278,994,0.7203219316
"American Indian / Alaska Native",Female,"North Dakota",38,228,87,315,0.7238095238
"American Indian / Alaska Native",Female,Ohio,39,55,13,68,0.8088235294
"American Indian / Alaska Native",Female,Oklahoma,40,3371,1608,4979,0.677043583
"American Indian / Alaska Native",Female,Oregon,41,319,103,422,0.7559241706
"American Indian / Alaska Native",Female,Pennsylvania,42,.,.,.,0.8474576271
"American Indian / Alaska Native",Female,"Rhode Island",44,.,.,.,0.8571428571
"American Indian / Alaska Native",Female,"South Carolina",45,43,21,64,0.671875
"American Indian / Alaska Native",Female,"South Dakota",46,279,191,470,0.5936170213
"American Indian / Alaska Native",Female,Tennessee,47,48,15,63,0.7619047619
"American Indian / Alaska Native",Female,Texas,48,462,164,626,0.7380191693
"American Indian / Alaska Native",Female,Utah,49,81,33,114,0.7105263158
"American Indian / Alaska Native",Female,Vermont,50,.,.,.,0.7777777778
"American Indian / Alaska Native",Female,Virginia,51,28,14,42,0.6666666667
"American Indian / Alaska Native",Female,Washington,53,774,271,1045,0.7406698565
"American Indian / Alaska Native",Female,"West Virginia",54,.,.,.,0.8
"American Indian / Alaska Native",Female,Wisconsin,55,450,118,568,0.7922535211
"American Indian / Alaska Native",Female,Wyoming,56,80,16,96,0.8333333333
,,,,0,0,0,0
