RACE_NAME,STATE_NAME,STATE_FIPS,BENE_YES,BENE_NO,TOTAL_BENE,BENE_YES_PCT
Unknown,Alabama,1,1372,206,1578,0.8694550063
Unknown,Alaska,2,408,78,486,0.8395061728
Unknown,Arizona,4,3565,543,4108,0.86781889
Unknown,Arkansas,5,936,181,1117,0.8379588183
Unknown,California,6,15733,2373,18106,0.8689384734
Unknown,Colorado,8,2808,461,3269,0.8589782808
Unknown,Connecticut,9,3502,480,3982,0.879457559
Unknown,Delaware,10,992,133,1125,0.8817777778
Unknown,"District of Columbia",11,236,46,282,0.8368794326
Unknown,Florida,12,12943,2108,15051,0.8599428609
Unknown,Georgia,13,3621,627,4248,0.8524011299
Unknown,Hawaii,15,351,57,408,0.8602941176
Unknown,Idaho,16,862,127,989,0.8715874621
Unknown,Illinois,17,8016,1015,9031,0.8876093456
Unknown,Indiana,18,4931,636,5567,0.885755344
Unknown,Iowa,19,2521,283,2804,0.8990727532
Unknown,Kansas,20,1900,243,2143,0.8866075595
Unknown,Kentucky,21,1977,329,2306,0.8573287077
Unknown,Louisiana,22,1784,308,2092,0.8527724665
Unknown,Maine,23,1154,150,1304,0.8849693252
Unknown,Maryland,24,4428,727,5155,0.858971872
Unknown,Massachusetts,25,7007,1088,8095,0.8655960469
Unknown,Michigan,26,7191,1095,8286,0.8678493845
Unknown,Minnesota,27,2616,386,3002,0.871419054
Unknown,Mississippi,28,802,158,960,0.8354166667
Unknown,Missouri,29,2909,408,3317,0.8769972867
Unknown,Montana,30,809,116,925,0.8745945946
Unknown,Nebraska,31,1628,202,1830,0.8896174863
Unknown,Nevada,32,1211,236,1447,0.8369039392
Unknown,"New Hampshire",33,1568,188,1756,0.8929384966
Unknown,"New Jersey",34,6987,1044,8031,0.8700037355
Unknown,"New Mexico",35,768,117,885,0.8677966102
Unknown,"New York",36,15293,2936,18229,0.838937956
Unknown,"North Carolina",37,5157,802,5959,0.86541366
Unknown,"North Dakota",38,401,60,461,0.8698481562
Unknown,Ohio,39,10396,1450,11846,0.8775958129
Unknown,Oklahoma,40,1304,228,1532,0.8511749347
Unknown,Oregon,41,1928,326,2254,0.8553682343
Unknown,Pennsylvania,42,8717,1114,9831,0.8866849761
Unknown,"Rhode Island",44,927,127,1054,0.8795066414
Unknown,"South Carolina",45,3138,480,3618,0.8673300166
Unknown,"South Dakota",46,569,71,640,0.8890625
Unknown,Tennessee,47,3209,458,3667,0.8751022634
Unknown,Texas,48,7802,1346,9148,0.852864014
Unknown,Utah,49,817,159,976,0.8370901639
Unknown,Vermont,50,1052,132,1184,0.8885135135
Unknown,Virginia,51,4897,693,5590,0.8760286225
Unknown,Washington,53,4161,710,4871,0.8542393759
Unknown,"West Virginia",54,614,94,708,0.8672316384
Unknown,Wisconsin,55,4720,515,5235,0.9016236867
Unknown,Wyoming,56,480,77,557,0.8617594255
"Non-Hispanic White",Alabama,1,143732,26512,170244,0.8442705763
"Non-Hispanic White",Alaska,2,15381,2954,18335,0.8388873739
"Non-Hispanic White",Arizona,4,156834,27641,184475,0.8501639789
"Non-Hispanic White",Arkansas,5,107453,22655,130108,0.8258754266
"Non-Hispanic White",California,6,489330,87697,577027,0.8480192435
"Non-Hispanic White",Colorado,8,96899,17049,113948,0.8503791203
"Non-Hispanic White",Connecticut,9,100594,14220,114814,0.8761475081
"Non-Hispanic White",Delaware,10,40610,5750,46360,0.8759706644
"Non-Hispanic White","District of Columbia",11,3055,517,3572,0.8552631579
"Non-Hispanic White",Florida,12,523611,93444,617055,0.8485645526
"Non-Hispanic White",Georgia,13,199516,38856,238372,0.8369942779
"Non-Hispanic White",Hawaii,15,7713,1396,9109,0.8467449775
"Non-Hispanic White",Idaho,16,49686,8906,58592,0.8479997269
"Non-Hispanic White",Illinois,17,378255,56954,435209,0.8691341401
"Non-Hispanic White",Indiana,18,241576,39588,281164,0.859199613
"Non-Hispanic White",Iowa,19,142035,18159,160194,0.8866436945
"Non-Hispanic White",Kansas,20,109100,16378,125478,0.8694751271
"Non-Hispanic White",Kentucky,21,177638,36682,214320,0.8288447182
"Non-Hispanic White",Louisiana,22,108062,21567,129629,0.8336251919
"Non-Hispanic White",Maine,23,54779,7514,62293,0.879376495
"Non-Hispanic White",Maryland,24,132647,20997,153644,0.8633399287
"Non-Hispanic White",Massachusetts,25,212064,30216,242280,0.8752847945
"Non-Hispanic White",Michigan,26,304725,51407,356132,0.855651837
"Non-Hispanic White",Minnesota,27,132081,17196,149277,0.8848047589
"Non-Hispanic White",Mississippi,28,90591,20203,110794,0.8176525805
"Non-Hispanic White",Missouri,29,208285,34995,243280,0.8561534035
"Non-Hispanic White",Montana,30,40843,6430,47273,0.863981554
"Non-Hispanic White",Nebraska,31,74136,10622,84758,0.8746784964
"Non-Hispanic White",Nevada,32,54227,10257,64484,0.8409372868
"Non-Hispanic White","New Hampshire",33,55403,7643,63046,0.8787710561
"Non-Hispanic White","New Jersey",34,245423,38649,284072,0.8639464643
"Non-Hispanic White","New Mexico",35,33598,6658,40256,0.8346085056
"Non-Hispanic White","New York",36,393410,66610,460020,0.8552019477
"Non-Hispanic White","North Carolina",37,292694,50662,343356,0.8524505178
"Non-Hispanic White","North Dakota",38,29498,3648,33146,0.8899414711
"Non-Hispanic White",Ohio,39,351474,58901,410375,0.8564703016
"Non-Hispanic White",Oklahoma,40,120139,24394,144533,0.8312219355
"Non-Hispanic White",Oregon,41,97624,17563,115187,0.8475261965
"Non-Hispanic White",Pennsylvania,42,376976,54933,431909,0.8728134862
"Non-Hispanic White","Rhode Island",44,29676,4069,33745,0.8794191732
"Non-Hispanic White","South Carolina",45,166189,29794,195983,0.8479766102
"Non-Hispanic White","South Dakota",46,36204,4977,41181,0.8791432942
"Non-Hispanic White",Tennessee,47,220517,40185,260702,0.8458584898
"Non-Hispanic White",Texas,48,487529,96012,583541,0.8354665739
"Non-Hispanic White",Utah,49,51195,10235,61430,0.8333875956
"Non-Hispanic White",Vermont,50,30150,4366,34516,0.8735079383
"Non-Hispanic White",Virginia,51,209320,34447,243767,0.8586888299
"Non-Hispanic White",Washington,53,161577,28198,189775,0.851413516
"Non-Hispanic White","West Virginia",54,79044,14676,93720,0.8434058899
"Non-Hispanic White",Wisconsin,55,169126,21081,190207,0.8891681168
"Non-Hispanic White",Wyoming,56,20890,3860,24750,0.844040404
"Black or African-American",Alabama,1,42751,11808,54559,0.7835737459
"Black or African-American",Alaska,2,434,146,580,0.7482758621
"Black or African-American",Arizona,4,4879,1539,6418,0.7602056715
"Black or African-American",Arkansas,5,14540,4827,19367,0.7507616048
"Black or African-American",California,6,42922,12694,55616,0.7717563291
"Black or African-American",Colorado,8,2972,931,3903,0.7614655393
"Black or African-American",Connecticut,9,9625,2274,11899,0.8088915035
"Black or African-American",Delaware,10,7863,1946,9809,0.8016107656
"Black or African-American","District of Columbia",11,8754,2687,11441,0.7651429071
"Black or African-American",Florida,12,60417,17815,78232,0.7722798855
"Black or African-American",Georgia,13,66500,19933,86433,0.7693820647
"Black or African-American",Hawaii,15,215,76,291,0.7388316151
"Black or African-American",Idaho,16,136,48,184,0.7391304348
"Black or African-American",Illinois,17,53291,15741,69032,0.7719753158
"Black or African-American",Indiana,18,17273,5123,22396,0.7712537953
"Black or African-American",Iowa,19,2256,616,2872,0.7855153203
"Black or African-American",Kansas,20,4683,1245,5928,0.7899797571
"Black or African-American",Kentucky,21,9863,3015,12878,0.765879795
"Black or African-American",Louisiana,22,44154,14408,58562,0.7539701513
"Black or African-American",Maine,23,220,67,287,0.7665505226
"Black or African-American",Maryland,24,47481,13114,60595,0.7835795033
"Black or African-American",Massachusetts,25,12796,3428,16224,0.7887080868
"Black or African-American",Michigan,26,44576,14649,59225,0.7526551287
"Black or African-American",Minnesota,27,4516,1511,6027,0.7492948399
"Black or African-American",Mississippi,28,42619,14048,56667,0.7520955759
"Black or African-American",Missouri,29,17916,5335,23251,0.7705475033
"Black or African-American",Montana,30,75,27,102,0.7352941176
"Black or African-American",Nebraska,31,1798,480,2278,0.7892888499
"Black or African-American",Nevada,32,5577,1823,7400,0.7536486486
"Black or African-American","New Hampshire",33,358,80,438,0.8173515982
"Black or African-American","New Jersey",34,32889,9531,42420,0.7753182461
"Black or African-American","New Mexico",35,884,264,1148,0.7700348432
"Black or African-American","New York",36,57803,18502,76305,0.7575257192
"Black or African-American","North Carolina",37,75214,20923,96137,0.7823626699
"Black or African-American","North Dakota",38,95,43,138,0.6884057971
"Black or African-American",Ohio,39,35614,10720,46334,0.7686364225
"Black or African-American",Oklahoma,40,7423,2459,9882,0.751163732
"Black or African-American",Oregon,41,1208,386,1594,0.7578419072
"Black or African-American",Pennsylvania,42,30510,8718,39228,0.7777607831
"Black or African-American","Rhode Island",44,1427,342,1769,0.8066704353
"Black or African-American","South Carolina",45,47393,14382,61775,0.7671873735
"Black or African-American","South Dakota",46,110,57,167,0.6586826347
"Black or African-American",Tennessee,47,28174,7910,36084,0.7807892695
"Black or African-American",Texas,48,69937,21741,91678,0.7628547743
"Black or African-American",Utah,49,294,113,407,0.7223587224
"Black or African-American",Vermont,50,124,28,152,0.8157894737
"Black or African-American",Virginia,51,47523,11890,59413,0.7998754481
"Black or African-American",Washington,53,4619,1383,6002,0.7695768077
"Black or African-American","West Virginia",54,2141,656,2797,0.7654629961
"Black or African-American",Wisconsin,55,8320,2315,10635,0.78232252
"Black or African-American",Wyoming,56,101,34,135,0.7481481481
Other,Alabama,1,413,100,513,0.8050682261
Other,Alaska,2,274,71,345,0.7942028986
Other,Arizona,4,1362,298,1660,0.8204819277
Other,Arkansas,5,300,70,370,0.8108108108
Other,California,6,15722,2853,18575,0.8464064603
Other,Colorado,8,684,155,839,0.8152562574
Other,Connecticut,9,1074,160,1234,0.8703403566
Other,Delaware,10,345,54,399,0.8646616541
Other,"District of Columbia",11,117,31,148,0.7905405405
Other,Florida,12,4828,901,5729,0.8427299703
Other,Georgia,13,1240,248,1488,0.8333333333
Other,Hawaii,15,4475,681,5156,0.8679208689
Other,Idaho,16,296,62,358,0.8268156425
Other,Illinois,17,4011,716,4727,0.8485297229
Other,Indiana,18,907,194,1101,0.8237965486
Other,Iowa,19,447,83,530,0.8433962264
Other,Kansas,20,464,86,550,0.8436363636
Other,Kentucky,21,490,87,577,0.849220104
Other,Louisiana,22,574,113,687,0.8355167394
Other,Maine,23,246,45,291,0.8453608247
Other,Maryland,24,1794,356,2150,0.8344186047
Other,Massachusetts,25,2848,466,3314,0.8593844297
Other,Michigan,26,2736,558,3294,0.8306010929
Other,Minnesota,27,914,143,1057,0.8647114475
Other,Mississippi,28,237,54,291,0.8144329897
Other,Missouri,29,764,124,888,0.8603603604
Other,Montana,30,197,37,234,0.8418803419
Other,Nebraska,31,274,35,309,0.8867313916
Other,Nevada,32,1259,239,1498,0.8404539386
Other,"New Hampshire",33,309,47,356,0.8679775281
Other,"New Jersey",34,3742,718,4460,0.8390134529
Other,"New Mexico",35,324,88,412,0.786407767
Other,"New York",36,7620,1733,9353,0.8147118572
Other,"North Carolina",37,2527,483,3010,0.8395348837
Other,"North Dakota",38,131,24,155,0.8451612903
Other,Ohio,39,1950,327,2277,0.8563899868
Other,Oklahoma,40,546,130,676,0.8076923077
Other,Oregon,41,898,138,1036,0.8667953668
Other,Pennsylvania,42,2069,358,2427,0.8524927895
Other,"Rhode Island",44,417,64,481,0.8669438669
Other,"South Carolina",45,719,113,832,0.8641826923
Other,"South Dakota",46,120,22,142,0.8450704225
Other,Tennessee,47,769,165,934,0.8233404711
Other,Texas,48,4027,847,4874,0.8262207632
Other,Utah,49,393,91,484,0.8119834711
Other,Vermont,50,176,29,205,0.8585365854
Other,Virginia,51,1873,336,2209,0.8478949751
Other,Washington,53,2073,431,2504,0.8278753994
Other,"West Virginia",54,240,35,275,0.8727272727
Other,Wisconsin,55,785,98,883,0.8890147225
Other,Wyoming,56,96,14,110,0.8727272727
"Asian/Pacific Islander",Alabama,1,733,173,906,0.8090507726
"Asian/Pacific Islander",Alaska,2,1003,235,1238,0.810177706
"Asian/Pacific Islander",Arizona,4,3052,648,3700,0.8248648649
"Asian/Pacific Islander",Arkansas,5,608,168,776,0.7835051546
"Asian/Pacific Islander",California,6,132764,23820,156584,0.8478771777
"Asian/Pacific Islander",Colorado,8,1748,387,2135,0.818735363
"Asian/Pacific Islander",Connecticut,9,2316,420,2736,0.8464912281
"Asian/Pacific Islander",Delaware,10,811,143,954,0.8501048218
"Asian/Pacific Islander","District of Columbia",11,314,49,363,0.8650137741
"Asian/Pacific Islander",Florida,12,9762,2061,11823,0.8256787617
"Asian/Pacific Islander",Georgia,13,5210,1093,6303,0.8265905125
"Asian/Pacific Islander",Hawaii,15,18422,3080,21502,0.8567575109
"Asian/Pacific Islander",Idaho,16,459,76,535,0.8579439252
"Asian/Pacific Islander",Illinois,17,14151,2555,16706,0.8470609362
"Asian/Pacific Islander",Indiana,18,1699,321,2020,0.8410891089
"Asian/Pacific Islander",Iowa,19,976,177,1153,0.8464874241
"Asian/Pacific Islander",Kansas,20,1154,204,1358,0.8497790869
"Asian/Pacific Islander",Kentucky,21,719,177,896,0.8024553571
"Asian/Pacific Islander",Louisiana,22,1551,355,1906,0.8137460651
"Asian/Pacific Islander",Maine,23,286,41,327,0.874617737
"Asian/Pacific Islander",Maryland,24,8940,1784,10724,0.8336441626
"Asian/Pacific Islander",Massachusetts,25,7780,1247,9027,0.8618588678
"Asian/Pacific Islander",Michigan,26,5150,1158,6308,0.8164235891
"Asian/Pacific Islander",Minnesota,27,2531,674,3205,0.7897035881
"Asian/Pacific Islander",Mississippi,28,592,125,717,0.8256624826
"Asian/Pacific Islander",Missouri,29,1557,335,1892,0.8229386892
"Asian/Pacific Islander",Montana,30,150,31,181,0.8287292818
"Asian/Pacific Islander",Nebraska,31,531,106,637,0.8335949765
"Asian/Pacific Islander",Nevada,32,4950,1110,6060,0.8168316832
"Asian/Pacific Islander","New Hampshire",33,397,59,456,0.8706140351
"Asian/Pacific Islander","New Jersey",34,16273,3052,19325,0.8420698577
"Asian/Pacific Islander","New Mexico",35,473,110,583,0.8113207547
"Asian/Pacific Islander","New York",36,30354,5329,35683,0.8506571757
"Asian/Pacific Islander","North Carolina",37,3807,834,4641,0.8202973497
"Asian/Pacific Islander","North Dakota",38,91,14,105,0.8666666667
"Asian/Pacific Islander",Ohio,39,3606,713,4319,0.8349154897
"Asian/Pacific Islander",Oklahoma,40,1253,290,1543,0.8120544394
"Asian/Pacific Islander",Oregon,41,2527,491,3018,0.8373094765
"Asian/Pacific Islander",Pennsylvania,42,7206,1340,8546,0.8432014978
"Asian/Pacific Islander","Rhode Island",44,541,90,631,0.8573692552
"Asian/Pacific Islander","South Carolina",45,1284,277,1561,0.8225496477
"Asian/Pacific Islander","South Dakota",46,136,28,164,0.8292682927
"Asian/Pacific Islander",Tennessee,47,1616,327,1943,0.8317035512
"Asian/Pacific Islander",Texas,48,22055,4579,26634,0.8280768942
"Asian/Pacific Islander",Utah,49,1023,257,1280,0.79921875
"Asian/Pacific Islander",Vermont,50,176,39,215,0.8186046512
"Asian/Pacific Islander",Virginia,51,9120,1719,10839,0.8414060338
"Asian/Pacific Islander",Washington,53,11941,2138,14079,0.8481426238
"Asian/Pacific Islander","West Virginia",54,259,58,317,0.8170347003
"Asian/Pacific Islander",Wisconsin,55,1839,492,2331,0.7889317889
"Asian/Pacific Islander",Wyoming,56,78,20,98,0.7959183673
Hispanic,Alabama,1,1134,306,1440,0.7875
Hispanic,Alaska,2,608,151,759,0.8010540184
Hispanic,Arizona,4,21435,5806,27241,0.7868653867
Hispanic,Arkansas,5,1675,586,2261,0.7408226448
Hispanic,California,6,196432,49318,245750,0.7993163784
Hispanic,Colorado,8,12682,3238,15920,0.7966080402
Hispanic,Connecticut,9,9020,2188,11208,0.8047822984
Hispanic,Delaware,10,1296,309,1605,0.8074766355
Hispanic,"District of Columbia",11,732,222,954,0.7672955975
Hispanic,Florida,12,90874,18374,109248,0.8318138547
Hispanic,Georgia,13,5288,1516,6804,0.7771898883
Hispanic,Hawaii,15,2355,498,2853,0.825446898
Hispanic,Idaho,16,2315,656,2971,0.7791989229
Hispanic,Illinois,17,32586,8278,40864,0.7974256069
Hispanic,Indiana,18,4999,1211,6210,0.8049919485
Hispanic,Iowa,19,1677,417,2094,0.8008595989
Hispanic,Kansas,20,3949,881,4830,0.8175983437
Hispanic,Kentucky,21,1011,314,1325,0.7630188679
Hispanic,Louisiana,22,3335,755,4090,0.815403423
Hispanic,Maine,23,274,60,334,0.8203592814
Hispanic,Maryland,24,5679,1423,7102,0.7996339059
Hispanic,Massachusetts,25,19883,4712,24595,0.8084163448
Hispanic,Michigan,26,7334,1840,9174,0.7994331807
Hispanic,Minnesota,27,1909,474,2383,0.8010910617
Hispanic,Mississippi,28,729,214,943,0.7730646872
Hispanic,Missouri,29,2404,587,2991,0.803744567
Hispanic,Montana,30,475,117,592,0.8023648649
Hispanic,Nebraska,31,1765,486,2251,0.7840959574
Hispanic,Nevada,32,8846,2560,11406,0.7755567245
Hispanic,"New Hampshire",33,700,161,861,0.8130081301
Hispanic,"New Jersey",34,32679,8094,40773,0.8014862777
Hispanic,"New Mexico",35,21349,5525,26874,0.7944109548
Hispanic,"New York",36,51079,13170,64249,0.7950162648
Hispanic,"North Carolina",37,5954,1658,7612,0.7821860221
Hispanic,"North Dakota",38,181,46,227,0.7973568282
Hispanic,Ohio,39,5607,1420,7027,0.7979222997
Hispanic,Oklahoma,40,3391,973,4364,0.7770394134
Hispanic,Oregon,41,4380,1225,5605,0.7814451383
Hispanic,Pennsylvania,42,12749,3235,15984,0.7976101101
Hispanic,"Rhode Island",44,3667,772,4439,0.8260869565
Hispanic,"South Carolina",45,2164,553,2717,0.7964666912
Hispanic,"South Dakota",46,246,56,302,0.8145695364
Hispanic,Tennessee,47,2038,559,2597,0.7847516365
Hispanic,Texas,48,156295,41094,197389,0.7918121071
Hispanic,Utah,49,2700,815,3515,0.7681365576
Hispanic,Vermont,50,166,34,200,0.83
Hispanic,Virginia,51,5277,1285,6562,0.8041755562
Hispanic,Washington,53,8820,2244,11064,0.7971800434
Hispanic,"West Virginia",54,333,66,399,0.8345864662
Hispanic,Wisconsin,55,4078,889,4967,0.8210187236
Hispanic,Wyoming,56,946,258,1204,0.7857142857
"American Indian / Alaska Native",Alabama,1,172,55,227,0.7577092511
"American Indian / Alaska Native",Alaska,2,2081,850,2931,0.7099965882
"American Indian / Alaska Native",Arizona,4,3681,2789,6470,0.5689335394
"American Indian / Alaska Native",Arkansas,5,410,127,537,0.7635009311
"American Indian / Alaska Native",California,6,3043,930,3973,0.7659199597
"American Indian / Alaska Native",Colorado,8,289,101,390,0.741025641
"American Indian / Alaska Native",Connecticut,9,46,12,58,0.7931034483
"American Indian / Alaska Native",Delaware,10,.,.,.,0.8846153846
"American Indian / Alaska Native","District of Columbia",11,.,0,.,1
"American Indian / Alaska Native",Florida,12,390,112,502,0.7768924303
"American Indian / Alaska Native",Georgia,13,122,49,171,0.7134502924
"American Indian / Alaska Native",Hawaii,15,.,.,.,0.7906976744
"American Indian / Alaska Native",Idaho,16,351,111,462,0.7597402597
"American Indian / Alaska Native",Illinois,17,187,40,227,0.8237885463
"American Indian / Alaska Native",Indiana,18,102,27,129,0.7906976744
"American Indian / Alaska Native",Iowa,19,153,64,217,0.7050691244
"American Indian / Alaska Native",Kansas,20,518,173,691,0.7496382055
"American Indian / Alaska Native",Kentucky,21,55,12,67,0.8208955224
"American Indian / Alaska Native",Louisiana,22,134,40,174,0.7701149425
"American Indian / Alaska Native",Maine,23,162,42,204,0.7941176471
"American Indian / Alaska Native",Maryland,24,87,20,107,0.8130841121
"American Indian / Alaska Native",Massachusetts,25,150,39,189,0.7936507937
"American Indian / Alaska Native",Michigan,26,1096,268,1364,0.8035190616
"American Indian / Alaska Native",Minnesota,27,1104,412,1516,0.72823219
"American Indian / Alaska Native",Mississippi,28,83,56,139,0.5971223022
"American Indian / Alaska Native",Missouri,29,339,97,436,0.7775229358
"American Indian / Alaska Native",Montana,30,1129,506,1635,0.6905198777
"American Indian / Alaska Native",Nebraska,31,282,138,420,0.6714285714
"American Indian / Alaska Native",Nevada,32,455,185,640,0.7109375
"American Indian / Alaska Native","New Hampshire",33,.,.,.,0.8571428571
"American Indian / Alaska Native","New Jersey",34,106,33,139,0.7625899281
"American Indian / Alaska Native","New Mexico",35,2446,1542,3988,0.6133400201
"American Indian / Alaska Native","New York",36,807,221,1028,0.7850194553
"American Indian / Alaska Native","North Carolina",37,2031,635,2666,0.7618154539
"American Indian / Alaska Native","North Dakota",38,625,218,843,0.7413997628
"American Indian / Alaska Native",Ohio,39,120,27,147,0.8163265306
"American Indian / Alaska Native",Oklahoma,40,9600,3716,13316,0.7209372184
"American Indian / Alaska Native",Oregon,41,798,302,1100,0.7254545455
"American Indian / Alaska Native",Pennsylvania,42,108,36,144,0.75
"American Indian / Alaska Native","Rhode Island",44,.,.,.,0.8591549296
"American Indian / Alaska Native","South Carolina",45,132,64,196,0.6734693878
"American Indian / Alaska Native","South Dakota",46,858,536,1394,0.6154949785
"American Indian / Alaska Native",Tennessee,47,122,40,162,0.7530864198
"American Indian / Alaska Native",Texas,48,1101,320,1421,0.7748064743
"American Indian / Alaska Native",Utah,49,310,191,501,0.618762475
"American Indian / Alaska Native",Vermont,50,.,.,.,0.5384615385
"American Indian / Alaska Native",Virginia,51,101,23,124,0.814516129
"American Indian / Alaska Native",Washington,53,1887,656,2543,0.7420369642
"American Indian / Alaska Native","West Virginia",54,.,.,.,0.7142857143
"American Indian / Alaska Native",Wisconsin,55,1010,310,1320,0.7651515152
"American Indian / Alaska Native",Wyoming,56,210,85,295,0.7118644068
